STATE,county,TRACT,AREALAND,POP100,H001001,H002001,H002005,H003001,H003002,H003003,P001001,P002001,P002002,P002005,P003001,P003002,P003003,P003004,P003005,P003006,P003007,P003008,P003009,P003010,P003026,P003047,P003063,P003070,P004001,P004002,P004003,P012001,P012002,P012026,P012A001,state,tract
42,1,30101,54957843,2528,973,973,0,973,914,59,2528,2528,0,0,2528,2507,2472,3,1,9,1,21,21,21,0,0,0,0,2528,47,2481,2528,1285,1243,2472,42,30101
42,1,30102,68781874,5106,1982,1982,0,1982,1803,179,5106,5106,0,0,5106,5062,5017,9,12,9,1,14,44,44,0,0,0,0,5106,61,5045,5106,2560,2546,5017,42,30102
42,1,30200,121198606,5080,1929,1929,0,1929,1802,127,5080,5080,0,0,5080,5022,4846,39,10,30,0,97,58,55,3,0,0,0,5080,333,4747,5080,2607,2473,4846,42,30200
42,1,30300,111834918,3550,1451,1451,0,1451,1279,172,3550,3550,0,0,3550,3505,3299,40,7,2,1,156,45,43,2,0,0,0,3550,346,3204,3550,1799,1751,3299,42,30300
42,1,30400,179013088,5438,2164,2164,0,2164,1980,184,5438,5438,0,0,5438,5386,5051,91,17,6,0,221,52,48,4,0,0,0,5438,400,5038,5438,2713,2725,5051,42,30400
42,1,30500,63850063,3779,1484,1484,0,1484,1422,62,3779,3779,0,0,3779,3744,3590,25,10,5,0,114,35,33,2,0,0,0,3779,264,3515,3779,1874,1905,3590,42,30500
42,1,30600,89101427,4539,1816,1816,0,1816,1687,129,4539,4539,0,0,4539,4498,4351,65,8,33,0,41,41,40,1,0,0,0,4539,104,4435,4539,2183,2356,4351,42,30600
42,1,30700,81911320,5798,2195,2195,0,2195,2110,85,5798,5798,0,0,5798,5771,5670,37,6,22,0,36,27,27,0,0,0,0,5798,118,5680,5798,2885,2913,5670,42,30700
42,1,30800,58758189,6132,2413,2413,0,2413,2297,116,6132,6132,0,0,6132,6103,5986,18,3,18,2,76,29,25,3,1,0,0,6132,163,5969,6132,3040,3092,5986,42,30800
42,1,30900,26848288,6572,2478,2478,0,2478,2372,106,6572,6572,0,0,6572,6512,6197,46,10,26,7,226,60,51,3,6,0,0,6572,391,6181,6572,3112,3460,6197,42,30900
42,1,31000,8042424,1345,493,493,0,493,483,10,1345,1345,0,0,1345,1336,1325,6,1,4,0,0,9,9,0,0,0,0,1345,3,1342,1345,667,678,1325,42,31000
42,1,31101,3114697,5014,2154,2154,0,2154,2079,75,5014,5014,0,0,5014,4980,4900,29,7,8,1,35,34,30,4,0,0,0,5014,104,4910,5014,2377,2637,4900,42,31101
42,1,31102,17309519,2041,773,773,0,773,741,32,2041,2041,0,0,2041,2027,1999,9,0,2,0,17,14,13,1,0,0,0,2041,27,2014,2041,992,1049,1999,42,31102
42,1,31201,67075113,3232,1267,1267,0,1267,1191,76,3232,3232,0,0,3232,3210,3115,47,11,15,0,22,22,21,1,0,0,0,3232,64,3168,3232,1584,1648,3115,42,31201
42,1,31202,28283284,2269,788,788,0,788,773,15,2269,2269,0,0,2269,2259,2242,4,2,8,1,2,10,10,0,0,0,0,2269,12,2257,2269,1125,1144,2242,42,31202
42,1,31203,45231607,2989,1112,1112,0,1112,1074,38,2989,2989,0,0,2989,2972,2939,2,7,20,0,4,17,17,0,0,0,0,2989,25,2964,2989,1476,1513,2939,42,31203
42,1,31300,4061516,3947,1692,1692,0,1692,1586,106,3947,3947,0,0,3947,3902,3839,22,4,17,0,20,45,44,1,0,0,0,3947,50,3897,3947,1875,2072,3839,42,31300
42,1,31401,29377531,3423,1358,1358,0,1358,1295,63,3423,3423,0,0,3423,3400,3192,105,13,35,1,54,23,20,2,1,0,0,3423,102,3321,3423,1651,1772,3192,42,31401
42,1,31402,57252864,2295,1007,1007,0,1007,936,71,2295,2295,0,0,2295,2272,2174,40,4,48,0,6,23,21,2,0,0,0,2295,21,2274,2295,1121,1174,2174,42,31402
42,1,31501,1503028,2896,599,599,0,599,558,41,2896,2896,0,0,2896,2856,2635,61,15,37,1,107,40,39,1,0,0,0,2896,170,2726,2896,1366,1530,2635,42,31501
42,1,31502,2748965,4594,2160,2160,0,2160,1983,177,4594,4594,0,0,4594,4456,3766,373,13,59,2,243,138,137,1,0,0,0,4594,431,4163,4594,2142,2452,3766,42,31502
42,1,31600,123306069,6023,2400,2400,0,2400,2228,172,6023,6023,0,0,6023,5946,5856,29,17,24,1,19,77,76,1,0,0,0,6023,55,5968,6023,3012,3011,5856,42,31600
42,1,31700,103250900,2702,1143,1143,0,1143,1059,84,2702,2702,0,0,2702,2679,2627,5,6,11,2,28,23,20,3,0,0,0,2702,32,2670,2702,1341,1361,2627,42,31700
42,3,10300,963024,3922,721,721,0,721,468,253,3922,3922,0,0,3922,3869,3075,522,12,147,4,109,53,50,3,0,0,0,3922,125,3797,3922,1601,2321,3075,42,10300
42,3,20100,1717785,5222,1623,1623,0,1623,1264,359,5222,5222,0,0,5222,5165,2941,2071,8,107,2,36,57,51,4,2,0,0,5222,68,5154,5222,3582,1640,2941,42,20100
42,3,20300,1573136,266,195,195,0,195,128,67,266,266,0,0,266,260,97,162,0,0,0,1,6,6,0,0,0,0,266,9,257,266,126,140,97,42,20300
42,3,30500,666954,2724,1540,1540,0,1540,1396,144,2724,2724,0,0,2724,2701,288,2374,6,19,1,13,23,23,0,0,0,0,2724,18,2706,2724,1155,1569,288,42,30500
42,3,40200,581844,2272,638,638,0,638,536,102,2272,2272,0,0,2272,2238,922,1208,12,77,2,17,34,27,7,0,0,0,2272,37,2235,2272,1000,1272,922,42,40200
42,3,40300,471111,4439,106,106,0,106,100,6,4439,4439,0,0,4439,4377,3584,556,17,183,4,33,62,50,12,0,0,0,4439,56,4383,4439,1858,2581,3584,42,40300
42,3,40400,453331,2562,1875,1875,0,1875,1655,220,2562,2562,0,0,2562,2521,1880,74,1,543,0,23,41,36,4,1,0,0,2562,61,2501,2562,1208,1354,1880,42,40400
42,3,40500,474523,3010,1386,1386,0,1386,1257,129,3010,3010,0,0,3010,2922,2409,174,12,306,1,20,88,85,2,1,0,0,3010,73,2937,3010,1572,1438,2409,42,40500
42,3,40600,233957,2271,1169,1169,0,1169,1059,110,2271,2271,0,0,2271,2208,1808,142,4,238,0,16,63,62,1,0,0,0,2271,65,2206,2271,1287,984,1808,42,40600
42,3,40900,1394334,3007,1558,1558,0,1558,1398,160,3007,3007,0,0,3007,2899,1892,851,2,129,4,21,108,100,6,0,2,0,3007,45,2962,3007,1569,1438,1892,42,40900
42,3,50100,791491,2143,1334,1334,0,1334,983,351,2143,2143,0,0,2143,2133,45,2075,5,2,0,6,10,9,1,0,0,0,2143,7,2136,2143,1015,1128,45,42,50100
42,3,50600,809588,2246,1171,1171,0,1171,1001,170,2246,2246,0,0,2246,2216,233,1949,7,13,1,13,30,21,9,0,0,0,2246,12,2234,2246,1010,1236,233,42,50600
42,3,50700,384254,2856,2022,2022,0,2022,1883,139,2856,2856,0,0,2856,2793,1956,401,3,412,2,19,63,54,8,1,0,0,2856,72,2784,2856,1405,1451,1956,42,50700
42,3,50900,471057,2109,1049,1049,0,1049,963,86,2109,2109,0,0,2109,2082,36,2023,12,0,1,10,27,17,10,0,0,0,2109,13,2096,2109,799,1310,36,42,50900
42,3,51000,651815,1250,1212,1212,0,1212,627,585,1250,1250,0,0,1250,1227,60,1156,2,8,0,1,23,18,4,1,0,0,1250,8,1242,1250,503,747,60,42,51000
42,3,51100,179165,1381,862,862,0,862,653,209,1381,1381,0,0,1381,1369,8,1353,3,0,0,5,12,5,7,0,0,0,1381,9,1372,1381,531,850,8,42,51100
42,3,60300,1052289,2585,1448,1448,0,1448,1252,196,2585,2585,0,0,2585,2510,1866,583,3,50,1,7,75,67,7,1,0,0,2585,21,2564,2585,1250,1335,1866,42,60300
42,3,60500,712719,1488,928,928,0,928,778,150,1488,1488,0,0,1488,1450,1247,178,3,15,0,7,38,34,2,0,2,0,1488,28,1460,1488,695,793,1247,42,60500
42,3,70300,420076,2224,1286,1286,0,1286,1214,72,2224,2224,0,0,2224,2185,1874,131,5,153,1,21,39,29,10,0,0,0,2224,95,2129,2224,1130,1094,1874,42,70300
42,3,70500,422950,3138,1993,1993,0,1993,1884,109,3138,3138,0,0,3138,3063,2510,287,4,240,1,21,75,70,5,0,0,0,3138,97,3041,3138,1590,1548,2510,42,70500
42,3,70600,297556,1977,1330,1330,0,1330,1262,68,1977,1977,0,0,1977,1935,1659,63,3,185,1,24,42,42,0,0,0,0,1977,75,1902,1977,992,985,1659,42,70600
42,3,70800,456609,1667,1062,1062,0,1062,1006,56,1667,1667,0,0,1667,1636,1269,114,1,235,0,17,31,30,1,0,0,0,1667,61,1606,1667,846,821,1269,42,70800
42,3,70900,783879,4748,2780,2780,0,2780,2596,184,4748,4748,0,0,4748,4665,3247,393,7,919,9,90,83,79,4,0,0,0,4748,150,4598,4748,2365,2383,3247,42,70900
42,3,80200,324494,1828,1019,1019,0,1019,930,89,1828,1828,0,0,1828,1810,1740,44,2,15,0,9,18,17,1,0,0,0,1828,28,1800,1828,846,982,1740,42,80200
42,3,80400,438055,1413,934,934,0,934,791,143,1413,1413,0,0,1413,1394,1071,150,2,166,1,4,19,18,1,0,0,0,1413,10,1403,1413,700,713,1071,42,80400
42,3,80600,402387,2118,1319,1319,0,1319,1221,98,2118,2118,0,0,2118,2069,1760,196,2,91,1,19,49,46,3,0,0,0,2118,64,2054,2118,1056,1062,1760,42,80600
42,3,80700,270864,1791,1180,1180,0,1180,1072,108,1791,1791,0,0,1791,1723,1067,508,15,107,0,26,68,60,7,0,1,0,1791,33,1758,1791,924,867,1067,42,80700
42,3,80900,381605,1920,1141,1141,0,1141,1019,122,1920,1920,0,0,1920,1893,1519,280,6,67,0,21,27,25,1,1,0,0,1920,37,1883,1920,901,1019,1519,42,80900
42,3,90100,672113,1957,1186,1186,0,1186,959,227,1957,1957,0,0,1957,1939,1799,102,0,38,0,0,18,18,0,0,0,0,1957,4,1953,1957,918,1039,1799,42,90100
42,3,90200,1832942,3149,1718,1718,0,1718,1543,175,3149,3149,0,0,3149,3120,2945,125,0,43,0,7,29,28,1,0,0,0,3149,25,3124,3149,1312,1837,2945,42,90200
42,3,90300,249906,1810,1019,1019,0,1019,885,134,1810,1810,0,0,1810,1780,1615,97,5,57,0,6,30,27,3,0,0,0,1810,23,1787,1810,830,980,1615,42,90300
42,3,100500,699607,2100,890,890,0,890,846,44,2100,2100,0,0,2100,2048,697,1330,0,14,0,7,52,44,8,0,0,0,2100,14,2086,2100,949,1151,697,42,100500
42,3,101100,1038546,2899,1504,1504,0,1504,1235,269,2899,2899,0,0,2899,2859,2493,318,6,36,0,6,40,40,0,0,0,0,2899,28,2871,2899,1377,1522,2493,42,101100
42,3,101400,955064,3549,1679,1679,0,1679,1540,139,3549,3549,0,0,3549,3505,3123,351,2,11,0,18,44,43,1,0,0,0,3549,45,3504,3549,1598,1951,3123,42,101400
42,3,101600,452809,1879,855,855,0,855,619,236,1879,1879,0,0,1879,1853,64,1755,22,1,0,11,26,23,3,0,0,0,1879,14,1865,1879,754,1125,64,42,101600
42,3,101700,382025,2004,978,978,0,978,752,226,2004,2004,0,0,2004,1951,415,1431,2,88,0,15,53,39,10,4,0,0,2004,12,1992,2004,906,1098,415,42,101700
42,3,101800,1194487,2742,1252,1252,0,1252,1196,56,2742,2742,0,0,2742,2711,2278,405,4,12,0,12,31,28,1,2,0,0,2742,19,2723,2742,1266,1476,2278,42,101800
42,3,110200,789946,4233,2247,2247,0,2247,2054,193,4233,4233,0,0,4233,4127,2559,1430,9,101,0,28,106,104,2,0,0,0,4233,79,4154,4233,1960,2273,2559,42,110200
42,3,110600,2093097,2516,1149,1149,0,1149,1055,94,2516,2516,0,0,2516,2463,1852,561,1,26,1,22,53,49,4,0,0,0,2516,44,2472,2516,1166,1350,1852,42,110600
42,3,111300,517692,3188,1655,1655,0,1655,1409,246,3188,3188,0,0,3188,3103,780,2202,11,62,0,48,85,76,8,1,0,0,3188,33,3155,3188,1375,1813,780,42,111300
42,3,111400,316843,1567,748,748,0,748,594,154,1567,1567,0,0,1567,1506,115,1351,1,31,0,8,61,55,6,0,0,0,1567,21,1546,1567,765,802,115,42,111400
42,3,111500,938240,3683,2407,2407,0,2407,2076,331,3683,3683,0,0,3683,3596,698,2778,17,85,0,18,87,77,7,3,0,0,3683,45,3638,3683,1588,2095,698,42,111500
42,3,120100,2837354,1684,436,436,0,436,405,31,1684,1684,0,0,1684,1638,358,1267,4,0,1,8,46,32,14,0,0,0,1684,26,1658,1684,901,783,358,42,120100
42,3,120200,643380,1632,824,824,0,824,710,114,1632,1632,0,0,1632,1598,20,1571,0,1,0,6,34,29,5,0,0,0,1632,15,1617,1632,707,925,20,42,120200
42,3,120300,1062255,2234,1059,1059,0,1059,889,170,2234,2234,0,0,2234,2193,85,2086,10,5,0,7,41,32,8,1,0,0,2234,14,2220,2234,976,1258,85,42,120300
42,3,120400,431769,1274,653,653,0,653,487,166,1274,1274,0,0,1274,1237,72,1133,4,17,1,10,37,31,6,0,0,0,1274,21,1253,1274,537,737,72,42,120400
42,3,120700,503733,1114,583,583,0,583,462,121,1114,1114,0,0,1114,1097,33,1047,3,4,1,9,17,15,2,0,0,0,1114,10,1104,1114,530,584,33,42,120700
42,3,120800,710143,1328,775,775,0,775,518,257,1328,1328,0,0,1328,1313,149,1154,7,0,0,3,15,11,4,0,0,0,1328,16,1312,1328,568,760,149,42,120800
42,3,130100,751112,2637,1299,1299,0,1299,1038,261,2637,2637,0,0,2637,2597,38,2534,13,2,2,8,40,30,9,0,1,0,2637,31,2606,2637,1144,1493,38,42,130100
42,3,130200,335147,1885,872,872,0,872,702,170,1885,1885,0,0,1885,1862,15,1832,6,4,0,5,23,20,2,1,0,0,1885,5,1880,1885,826,1059,15,42,130200
42,3,130300,555425,1913,1160,1160,0,1160,918,242,1913,1913,0,0,1913,1879,20,1846,3,2,1,7,34,29,2,0,3,0,1913,22,1891,1913,787,1126,20,42,130300
42,3,130400,481322,1734,887,887,0,887,690,197,1734,1734,0,0,1734,1711,11,1690,3,2,0,5,23,19,4,0,0,0,1734,7,1727,1734,786,948,11,42,130400
42,3,130600,1390176,3951,1890,1890,0,1890,1556,334,3951,3951,0,0,3951,3873,115,3706,12,9,0,31,78,53,16,1,8,0,3951,35,3916,3951,1645,2306,115,42,130600
42,3,140100,1460535,5538,1117,1117,0,1117,1059,58,5538,5538,0,0,5538,5430,3899,184,13,948,8,378,108,105,3,0,0,0,5538,157,5381,5538,3359,2179,3899,42,140100
42,3,140200,779772,2435,1281,1281,0,1281,1191,90,2435,2435,0,0,2435,2378,1771,120,1,465,1,20,57,52,4,1,0,0,2435,52,2383,2435,1112,1323,1771,42,140200
42,3,140300,955761,3422,1571,1571,0,1571,1511,60,3422,3422,0,0,3422,3383,3113,88,1,163,1,17,39,39,0,0,0,0,3422,46,3376,3422,1645,1777,3113,42,140300
42,3,140400,862130,2356,1003,1003,0,1003,965,38,2356,2356,0,0,2356,2329,2206,47,4,61,0,11,27,26,1,0,0,0,2356,38,2318,2356,1102,1254,2206,42,140400
42,3,140500,782899,2304,1208,1208,0,1208,1057,151,2304,2304,0,0,2304,2253,634,1564,9,37,0,9,51,50,1,0,0,0,2304,27,2277,2304,1054,1250,634,42,140500
42,3,140600,1781180,3309,1562,1562,0,1562,1476,86,3309,3309,0,0,3309,3255,2867,286,3,86,2,11,54,52,2,0,0,0,3309,42,3267,3309,1611,1698,2867,42,140600
42,3,140800,2391414,4383,1998,1998,0,1998,1919,79,4383,4383,0,0,4383,4327,3940,118,4,231,1,33,56,53,3,0,0,0,4383,95,4288,4383,2177,2206,3940,42,140800
42,3,141000,529037,1131,562,562,0,562,543,19,1131,1131,0,0,1131,1117,1062,35,1,17,0,2,14,14,0,0,0,0,1131,9,1122,1131,509,622,1062,42,141000
42,3,141100,1334273,1378,627,627,0,627,607,20,1378,1378,0,0,1378,1371,1335,22,0,9,0,5,7,7,0,0,0,0,1378,13,1365,1378,659,719,1335,42,141100
42,3,141300,2444006,4950,2575,2575,0,2575,2468,107,4950,4950,0,0,4950,4886,4190,229,5,416,6,40,64,55,8,1,0,0,4950,134,4816,4950,2271,2679,4190,42,141300
42,3,141400,2085961,5174,2496,2496,0,2496,2396,100,5174,5174,0,0,5174,5075,4557,150,6,326,0,36,99,97,2,0,0,0,5174,93,5081,5174,2428,2746,4557,42,141400
42,3,150100,2316165,1948,999,999,0,999,838,161,1948,1948,0,0,1948,1922,1461,450,1,8,0,2,26,26,0,0,0,0,1948,14,1934,1948,916,1032,1461,42,150100
42,3,150400,1085645,805,287,287,0,287,270,17,805,805,0,0,805,786,192,583,9,1,0,1,19,18,1,0,0,0,805,6,799,805,255,550,192,42,150400
42,3,151500,1912311,3386,1747,1747,0,1747,1451,296,3386,3386,0,0,3386,3335,1888,1385,11,23,0,28,51,43,8,0,0,0,3386,54,3332,3386,1526,1860,1888,42,151500
42,3,151600,835078,2608,1291,1291,0,1291,1184,107,2608,2608,0,0,2608,2596,2550,25,8,12,0,1,12,12,0,0,0,0,2608,18,2590,2608,1211,1397,2550,42,151600
42,3,151700,1185327,5224,2582,2582,0,2582,2430,152,5224,5224,0,0,5224,5145,4762,178,10,164,1,30,79,71,8,0,0,0,5224,93,5131,5224,2498,2726,4762,42,151700
42,3,160300,1256639,1999,880,880,0,880,805,75,1999,1999,0,0,1999,1984,1719,258,1,4,1,1,15,15,0,0,0,0,1999,7,1992,1999,957,1042,1719,42,160300
42,3,160400,284363,238,557,557,0,557,116,441,238,238,0,0,238,234,47,185,1,0,0,1,4,3,1,0,0,0,238,2,236,238,89,149,47,42,160400
42,3,160600,813573,1453,768,768,0,768,440,328,1453,1453,0,0,1453,1427,190,1221,6,0,0,10,26,20,5,0,1,0,1453,17,1436,1453,575,878,190,42,160600
42,3,160700,279432,584,246,246,0,246,216,30,584,584,0,0,584,578,464,113,1,0,0,0,6,6,0,0,0,0,584,0,584,584,272,312,464,42,160700
42,3,160800,1043166,2961,1492,1492,0,1492,1326,166,2961,2961,0,0,2961,2921,2767,134,4,10,0,6,40,20,19,0,0,1,2961,17,2944,2961,1452,1509,2767,42,160800
42,3,160900,1299498,2181,1378,1378,0,1378,1178,200,2181,2181,0,0,2181,2165,2055,87,5,13,0,5,16,16,0,0,0,0,2181,23,2158,2181,1027,1154,2055,42,160900
42,3,170200,1198690,3545,2235,2235,0,2235,1956,279,3545,3545,0,0,3545,3501,3399,60,5,28,5,4,44,41,3,0,0,0,3545,51,3494,3545,1801,1744,3399,42,170200
42,3,170600,798368,2046,1088,1088,0,1088,934,154,2046,2046,0,0,2046,2030,1924,86,2,12,2,4,16,16,0,0,0,0,2046,19,2027,2046,1061,985,1924,42,170600
42,3,180300,797404,3220,1505,1505,0,1505,1302,203,3220,3220,0,0,3220,3154,2497,643,2,9,0,3,66,60,6,0,0,0,3220,22,3198,3220,1483,1737,2497,42,180300
42,3,180600,799048,889,404,404,0,404,378,26,889,889,0,0,889,882,857,17,0,7,0,1,7,7,0,0,0,0,889,2,887,889,409,480,857,42,180600
42,3,180700,378866,2349,1085,1085,0,1085,989,96,2349,2349,0,0,2349,2332,1998,308,5,16,0,5,17,17,0,0,0,0,2349,16,2333,2349,1185,1164,1998,42,180700
42,3,180900,1096672,2783,1298,1298,0,1298,1074,224,2783,2783,0,0,2783,2691,346,2288,15,17,3,22,92,69,23,0,0,0,2783,43,2740,2783,1287,1496,346,42,180900
42,3,190300,816675,2159,1258,1258,0,1258,1133,125,2159,2159,0,0,2159,2143,2080,42,4,7,0,10,16,16,0,0,0,0,2159,14,2145,2159,1044,1115,2080,42,190300
42,3,191100,1559716,2696,1417,1417,0,1417,1276,141,2696,2696,0,0,2696,2654,2540,66,1,41,2,4,42,42,0,0,0,0,2696,17,2679,2696,1307,1389,2540,42,191100
42,3,191400,1024886,3061,1728,1728,0,1728,1533,195,3061,3061,0,0,3061,3014,2798,180,9,17,1,9,47,44,3,0,0,0,3061,25,3036,3061,1500,1561,2798,42,191400
42,3,191500,798262,2309,1180,1180,0,1180,1064,116,2309,2309,0,0,2309,2286,2151,102,2,21,1,9,23,21,2,0,0,0,2309,24,2285,2309,1156,1153,2151,42,191500
42,3,191600,2458143,4661,2120,2120,0,2120,1975,145,4661,4661,0,0,4661,4581,4155,354,11,35,0,26,80,77,3,0,0,0,4661,71,4590,4661,2232,2429,4155,42,191600
42,3,191700,1905704,3634,1632,1632,0,1632,1558,74,3634,3634,0,0,3634,3602,3469,89,3,30,4,7,32,27,4,1,0,0,3634,28,3606,3634,1715,1919,3469,42,191700
42,3,191800,1461064,5818,2545,2545,0,2545,2451,94,5818,5818,0,0,5818,5759,5628,52,6,59,0,14,59,55,4,0,0,0,5818,56,5762,5818,2676,3142,5628,42,191800
42,3,191900,595822,2447,1095,1095,0,1095,1024,71,2447,2447,0,0,2447,2416,2353,36,1,19,0,7,31,29,2,0,0,0,2447,25,2422,2447,1134,1313,2353,42,191900
42,3,192000,1385637,4111,1928,1928,0,1928,1821,107,4111,4111,0,0,4111,4076,3832,148,8,52,2,34,35,35,0,0,0,0,4111,76,4035,4111,1911,2200,3832,42,192000
42,3,192100,573931,56,40,40,0,40,30,10,56,56,0,0,56,53,38,13,0,0,0,2,3,3,0,0,0,0,56,0,56,56,29,27,38,42,192100
42,3,201600,963630,530,233,233,0,233,231,2,530,530,0,0,530,524,509,9,0,1,0,5,6,6,0,0,0,0,530,9,521,530,251,279,509,42,201600
42,3,201700,611508,495,231,231,0,231,189,42,495,495,0,0,495,489,395,87,3,1,0,3,6,6,0,0,0,0,495,2,493,495,219,276,395,42,201700
42,3,201800,1391313,3053,1294,1294,0,1294,1146,148,3053,3053,0,0,3053,2983,2177,760,8,16,0,22,70,52,6,0,12,0,3053,26,3027,3053,1440,1613,2177,42,201800
42,3,201900,554246,466,211,211,0,211,149,62,466,466,0,0,466,465,292,165,0,6,0,2,1,1,0,0,0,0,466,3,463,466,201,265,292,42,201900
42,3,202000,1609620,2954,1415,1415,0,1415,1239,176,2954,2954,0,0,2954,2903,2406,437,8,15,1,36,51,46,5,0,0,0,2954,45,2909,2954,1414,1540,2406,42,202000
42,3,202100,353700,595,238,238,0,238,232,6,595,595,0,0,595,591,150,431,1,0,0,9,4,4,0,0,0,0,595,3,592,595,274,321,150,42,202100
42,3,202200,893252,2996,1327,1327,0,1327,1239,88,2996,2996,0,0,2996,2945,2388,517,2,26,0,12,51,46,5,0,0,0,2996,29,2967,2996,1392,1604,2388,42,202200
42,3,202300,2576400,4540,2203,2203,0,2203,2079,124,4540,4540,0,0,4540,4434,4055,158,4,200,1,16,106,101,5,0,0,0,4540,51,4489,4540,2168,2372,4055,42,202300
42,3,210700,702750,2506,1348,1348,0,1348,1084,264,2506,2506,0,0,2506,2463,303,2143,2,7,0,8,43,41,2,0,0,0,2506,16,2490,2506,1088,1418,303,42,210700
42,3,210800,1070674,39,29,29,0,29,27,2,39,39,0,0,39,37,13,24,0,0,0,0,2,2,0,0,0,0,39,0,39,39,20,19,13,42,210800
42,3,220100,202266,508,390,390,0,390,308,82,508,508,0,0,508,502,385,105,2,7,0,3,6,6,0,0,0,0,508,11,497,508,296,212,385,42,220100
42,3,220400,518350,886,675,675,0,675,465,210,886,886,0,0,886,872,458,386,4,17,1,6,14,12,2,0,0,0,886,11,875,886,445,441,458,42,220400
42,3,220500,1013662,270,251,251,0,251,154,97,270,270,0,0,270,261,226,23,0,12,0,0,9,9,0,0,0,0,270,3,267,270,177,93,226,42,220500
42,3,220600,423658,1938,1238,1238,0,1238,1001,237,1938,1938,0,0,1938,1896,1005,858,4,14,0,15,42,41,1,0,0,0,1938,44,1894,1938,1057,881,1005,42,220600
42,3,230400,577916,2635,1735,1735,0,1735,1396,339,2635,2635,0,0,2635,2587,1882,638,7,30,4,26,48,45,3,0,0,0,2635,44,2591,2635,1340,1295,1882,42,230400
42,3,240600,1124965,2540,1415,1415,0,1415,1202,213,2540,2540,0,0,2540,2520,2471,33,2,7,2,5,20,20,0,0,0,0,2540,28,2512,2540,1215,1325,2471,42,240600
42,3,241200,720175,1254,621,621,0,621,517,104,1254,1254,0,0,1254,1226,1119,93,2,8,0,4,28,20,8,0,0,0,1254,4,1250,1254,592,662,1119,42,241200
42,3,250300,246070,1262,754,754,0,754,551,203,1262,1262,0,0,1262,1240,312,920,0,3,0,5,22,22,0,0,0,0,1262,8,1254,1262,615,647,312,42,250300
42,3,250700,556540,973,450,450,0,450,384,66,973,973,0,0,973,952,190,757,1,0,1,3,21,21,0,0,0,0,973,14,959,973,444,529,190,42,250700
42,3,250900,677951,1751,856,856,0,856,746,110,1751,1751,0,0,1751,1703,828,859,4,4,0,8,48,33,9,6,0,0,1751,30,1721,1751,775,976,828,42,250900
42,3,260200,2444502,2772,1226,1226,0,1226,1097,129,2772,2772,0,0,2772,2706,2174,491,5,25,0,11,66,59,6,1,0,0,2772,32,2740,2772,1312,1460,2174,42,260200
42,3,260700,713083,1897,890,890,0,890,788,102,1897,1897,0,0,1897,1857,1208,624,3,5,0,17,40,36,4,0,0,0,1897,23,1874,1897,922,975,1208,42,260700
42,3,260900,771219,2526,879,879,0,879,744,135,2526,2526,0,0,2526,2501,56,2427,5,0,0,13,25,19,6,0,0,0,2526,28,2498,2526,1009,1517,56,42,260900
42,3,261200,1118835,1077,503,503,0,503,476,27,1077,1077,0,0,1077,1062,920,137,1,2,0,2,15,12,3,0,0,0,1077,6,1071,1077,494,583,920,42,261200
42,3,261400,1239870,3293,1622,1622,0,1622,1273,349,3293,3293,0,0,3293,3228,955,2244,1,9,0,19,65,54,10,0,1,0,3293,31,3262,3293,1533,1760,955,42,261400
42,3,261500,1135934,1983,990,990,0,990,814,176,1983,1983,0,0,1983,1919,698,1186,1,21,1,12,64,47,17,0,0,0,1983,25,1958,1983,891,1092,698,42,261500
42,3,262000,1574574,3040,1392,1392,0,1392,1270,122,3040,3040,0,0,3040,3014,2325,679,1,6,0,3,26,22,4,0,0,0,3040,15,3025,3040,1368,1672,2325,42,262000
42,3,270100,1017714,2868,1286,1286,0,1286,1158,128,2868,2868,0,0,2868,2840,2431,377,2,16,2,12,28,28,0,0,0,0,2868,12,2856,2868,1318,1550,2431,42,270100
42,3,270300,604726,2129,1049,1049,0,1049,931,118,2129,2129,0,0,2129,2091,1796,266,0,16,0,13,38,31,7,0,0,0,2129,14,2115,2129,957,1172,1796,42,270300
42,3,270400,1785377,3026,599,599,0,599,529,70,3026,3026,0,0,3026,3003,1425,1492,7,6,0,73,23,17,6,0,0,0,3026,114,2912,3026,2340,686,1425,42,270400
42,3,270800,1276263,3053,1329,1329,0,1329,1260,69,3053,3053,0,0,3053,3019,2799,197,0,9,0,14,34,32,2,0,0,0,3053,21,3032,3053,1392,1661,2799,42,270800
42,3,271500,1461581,3925,1849,1849,0,1849,1599,250,3925,3925,0,0,3925,3844,3160,650,3,7,1,23,81,71,9,1,0,0,3925,21,3904,3925,1922,2003,3160,42,271500
42,3,280500,1106200,485,193,193,0,193,185,8,485,485,0,0,485,481,426,54,0,0,0,1,4,4,0,0,0,0,485,3,482,485,247,238,426,42,280500
42,3,280700,1023755,1447,667,667,0,667,635,32,1447,1447,0,0,1447,1437,1017,404,0,9,2,5,10,10,0,0,0,0,1447,12,1435,1447,683,764,1017,42,280700
42,3,280800,2575799,1099,644,644,0,644,386,258,1099,1099,0,0,1099,1060,61,989,1,4,4,1,39,36,3,0,0,0,1099,16,1083,1099,468,631,61,42,280800
42,3,281100,1739428,3093,1499,1499,0,1499,1426,73,3093,3093,0,0,3093,3044,2823,135,3,68,0,15,49,49,0,0,0,0,3093,23,3070,3093,1458,1635,2823,42,281100
42,3,281200,698316,1028,551,551,0,551,523,28,1028,1028,0,0,1028,1016,953,38,1,16,0,8,12,12,0,0,0,0,1028,5,1023,1028,448,580,953,42,281200
42,3,281400,1347251,2571,1102,1102,0,1102,1016,86,2571,2571,0,0,2571,2506,1630,846,10,8,0,12,65,57,7,1,0,0,2571,28,2543,2571,1164,1407,1630,42,281400
42,3,281500,608996,1628,717,717,0,717,667,50,1628,1628,0,0,1628,1607,1508,87,2,5,0,5,21,20,1,0,0,0,1628,11,1617,1628,794,834,1508,42,281500
42,3,290100,1273020,2191,1070,1070,0,1070,960,110,2191,2191,0,0,2191,2168,2063,88,3,7,3,4,23,20,0,0,3,0,2191,9,2182,2191,1096,1095,2063,42,290100
42,3,290200,1456184,4320,2045,2045,0,2045,1872,173,4320,4320,0,0,4320,4278,4190,66,5,15,1,1,42,39,2,0,1,0,4320,24,4296,4320,1984,2336,4190,42,290200
42,3,290400,1619779,4174,1999,1999,0,1999,1839,160,4174,4174,0,0,4174,4142,4047,69,5,18,0,3,32,31,1,0,0,0,4174,27,4147,4174,1974,2200,4047,42,290400
42,3,300100,791111,4432,1923,1923,0,1923,1684,239,4432,4432,0,0,4432,4356,2784,1481,8,49,1,33,76,62,14,0,0,0,4432,41,4391,4432,2052,2380,2784,42,300100
42,3,310100,4555477,457,228,228,0,228,203,25,457,457,0,0,457,452,449,1,0,2,0,0,5,5,0,0,0,0,457,1,456,457,232,225,449,42,310100
42,3,310200,2519424,3671,1619,1619,0,1619,1540,79,3671,3671,0,0,3671,3655,3623,18,2,11,0,1,16,12,2,2,0,0,3671,25,3646,3671,1756,1915,3623,42,310200
42,3,310300,2095221,937,387,387,0,387,374,13,937,937,0,0,937,920,812,88,18,2,0,0,17,12,5,0,0,0,937,7,930,937,476,461,812,42,310300
42,3,320400,857953,2244,953,953,0,953,901,52,2244,2244,0,0,2244,2234,2156,62,0,16,0,0,10,8,2,0,0,0,2244,6,2238,2244,1074,1170,2156,42,320400
42,3,320600,1469225,2419,1077,1077,0,1077,1034,43,2419,2419,0,0,2419,2405,2308,74,1,17,0,5,14,14,0,0,0,0,2419,11,2408,2419,1130,1289,2308,42,320600
42,3,320700,1310516,1797,773,773,0,773,738,35,1797,1797,0,0,1797,1779,1751,11,4,10,1,2,18,18,0,0,0,0,1797,22,1775,1797,880,917,1751,42,320700
42,3,401100,13218141,4642,2138,2138,0,2138,2038,100,4642,4642,0,0,4642,4609,4516,70,1,20,0,2,33,31,2,0,0,0,4642,17,4625,4642,2203,2439,4516,42,401100
42,3,401200,2647034,3458,1850,1850,0,1850,1559,291,3458,3458,0,0,3458,3399,3070,301,4,16,0,8,59,53,5,1,0,0,3458,38,3420,3458,1517,1941,3070,42,401200
42,3,401300,2968594,2834,1258,1258,0,1258,1199,59,2834,2834,0,0,2834,2826,2781,33,1,9,0,2,8,8,0,0,0,0,2834,5,2829,2834,1335,1499,2781,42,401300
42,3,402000,1325252,3543,1700,1700,0,1700,1507,193,3543,3543,0,0,3543,3515,3367,122,4,8,1,13,28,24,4,0,0,0,3543,19,3524,3543,1582,1961,3367,42,402000
42,3,403500,3224070,4993,2556,2556,0,2556,2170,386,4993,4993,0,0,4993,4924,4683,182,14,30,2,13,69,55,14,0,0,0,4993,45,4948,4993,2339,2654,4683,42,403500
42,3,404000,5976002,1362,682,682,0,682,606,76,1362,1362,0,0,1362,1348,1319,26,0,2,0,1,14,14,0,0,0,0,1362,1,1361,1362,613,749,1319,42,404000
42,3,405000,24279959,1286,569,569,0,569,527,42,1286,1286,0,0,1286,1284,1280,1,0,2,0,1,2,2,0,0,0,0,1286,1,1285,1286,648,638,1280,42,405000
42,3,406000,33460199,2504,1031,1031,0,1031,985,46,2504,2504,0,0,2504,2498,2472,5,1,17,1,2,6,6,0,0,0,0,2504,6,2498,2504,1261,1243,2472,42,406000
42,3,407001,48762695,4680,1944,1944,0,1944,1860,84,4680,4680,0,0,4680,4664,4634,8,7,5,0,10,16,15,1,0,0,0,4680,23,4657,4680,2288,2392,4634,42,407001
42,3,407002,26289545,6883,2640,2640,0,2640,2518,122,6883,6883,0,0,6883,6859,6806,26,6,20,0,1,24,19,5,0,0,0,6883,26,6857,6883,3354,3529,6806,42,407002
42,3,408001,26047748,4325,1688,1688,0,1688,1594,94,4325,4325,0,0,4325,4303,4251,20,5,18,0,9,22,22,0,0,0,0,4325,46,4279,4325,2037,2288,4251,42,408001
42,3,408002,11644392,4906,1820,1820,0,1820,1759,61,4906,4906,0,0,4906,4888,4824,23,2,35,0,4,18,18,0,0,0,0,4906,14,4892,4906,2393,2513,4824,42,408002
42,3,409000,43479000,7683,2500,2500,0,2500,2411,89,7683,7683,0,0,7683,7631,7465,61,5,86,2,12,52,48,4,0,0,0,7683,57,7626,7683,3765,3918,7465,42,409000
42,3,410000,2319148,1149,478,478,0,478,464,14,1149,1149,0,0,1149,1147,1133,0,1,10,0,3,2,2,0,0,0,0,1149,9,1140,1149,568,581,1133,42,410000
42,3,411000,40394417,5996,2018,2018,0,2018,1944,74,5996,5996,0,0,5996,5952,5750,65,0,133,0,4,44,44,0,0,0,0,5996,41,5955,5996,3005,2991,5750,42,411000
42,3,412001,22411534,6501,2341,2341,0,2341,2258,83,6501,6501,0,0,6501,6458,6167,75,2,190,6,18,43,43,0,0,0,0,6501,40,6461,6501,3213,3288,6167,42,412001
42,3,412002,12772284,4863,1632,1632,0,1632,1608,24,4863,4863,0,0,4863,4833,4634,41,3,138,16,1,30,26,4,0,0,0,4863,21,4842,4863,2403,2460,4634,42,412002
42,3,413100,15933687,6773,2656,2656,0,2656,2535,121,6773,6773,0,0,6773,6722,6253,129,2,329,1,8,51,49,2,0,0,0,6773,64,6709,6773,3283,3490,6253,42,413100
42,3,413201,3769596,3850,1625,1625,0,1625,1582,43,3850,3850,0,0,3850,3819,3680,33,4,94,0,8,31,27,4,0,0,0,3850,36,3814,3850,1862,1988,3680,42,413201
42,3,413202,4061362,2715,1143,1143,0,1143,1111,32,2715,2715,0,0,2715,2692,2635,13,0,40,0,4,23,21,2,0,0,0,2715,17,2698,2715,1284,1431,2635,42,413202
42,3,413300,5809620,5116,1875,1875,0,1875,1807,68,5116,5116,0,0,5116,5103,4991,19,6,82,0,5,13,13,0,0,0,0,5116,25,5091,5116,2437,2679,4991,42,413300
42,3,413400,4498283,4584,1663,1663,0,1663,1638,25,4584,4584,0,0,4584,4556,4349,44,0,160,0,3,28,27,1,0,0,0,4584,17,4567,4584,2176,2408,4349,42,413400
42,3,413500,8773154,5984,2735,2735,0,2735,2486,249,5984,5984,0,0,5984,5916,5541,137,3,221,1,13,68,66,0,0,0,2,5984,43,5941,5984,2761,3223,5541,42,413500
42,3,414101,9645474,5612,1943,1943,0,1943,1892,51,5612,5612,0,0,5612,5606,5502,33,0,65,1,5,6,6,0,0,0,0,5612,25,5587,5612,2724,2888,5502,42,414101
42,3,414102,18035230,5971,2498,2498,0,2498,2248,250,5971,5971,0,0,5971,5953,5783,57,8,93,0,12,18,18,0,0,0,0,5971,33,5938,5971,2933,3038,5783,42,414102
42,3,414200,13857286,5943,2186,2186,0,2186,2113,73,5943,5943,0,0,5943,5920,5831,28,0,57,0,4,23,22,1,0,0,0,5943,35,5908,5943,2913,3030,5831,42,414200
42,3,415001,32884456,4042,1499,1499,0,1499,1421,78,4042,4042,0,0,4042,4027,3927,53,4,35,2,6,15,15,0,0,0,0,4042,22,4020,4042,1984,2058,3927,42,415001
42,3,415002,13014818,2767,958,958,0,958,926,32,2767,2767,0,0,2767,2749,2587,35,0,112,0,15,18,16,2,0,0,0,2767,15,2752,2767,1364,1403,2587,42,415002
42,3,416000,5798772,1802,838,838,0,838,797,41,1802,1802,0,0,1802,1796,1795,1,0,0,0,0,6,6,0,0,0,0,1802,2,1800,1802,868,934,1795,42,416000
42,3,417100,1093987,2400,1079,1079,0,1079,1020,59,2400,2400,0,0,2400,2394,2382,2,2,4,0,4,6,6,0,0,0,0,2400,4,2396,2400,1118,1282,2382,42,417100
42,3,417200,1321709,1428,723,723,0,723,665,58,1428,1428,0,0,1428,1423,1409,9,1,1,0,3,5,5,0,0,0,0,1428,4,1424,1428,685,743,1409,42,417200
42,3,418000,1241232,1899,887,887,0,887,853,34,1899,1899,0,0,1899,1899,1889,5,1,4,0,0,0,0,0,0,0,0,1899,9,1890,1899,867,1032,1889,42,418000
42,3,419000,15455110,3242,1637,1637,0,1637,1522,115,3242,3242,0,0,3242,3228,3169,22,3,32,0,2,14,14,0,0,0,0,3242,18,3224,3242,1535,1707,3169,42,419000
42,3,420000,841335,1550,931,931,0,931,858,73,1550,1550,0,0,1550,1543,1442,16,1,81,0,3,7,7,0,0,0,0,1550,10,1540,1550,720,830,1442,42,420000
42,3,421100,8762384,4197,1613,1613,0,1613,1553,60,4197,4197,0,0,4197,4174,3956,54,3,153,0,8,23,23,0,0,0,0,4197,28,4169,4197,2138,2059,3956,42,421100
42,3,421200,9454467,4659,1768,1768,0,1768,1695,73,4659,4659,0,0,4659,4631,4479,20,1,116,0,15,28,27,1,0,0,0,4659,73,4586,4659,2269,2390,4479,42,421200
42,3,422000,20288843,5436,1942,1942,0,1942,1875,67,5436,5436,0,0,5436,5395,5071,30,1,284,2,7,41,39,2,0,0,0,5436,37,5399,5436,2698,2738,5071,42,422000
42,3,423000,860920,2960,1584,1584,0,1584,1499,85,2960,2960,0,0,2960,2945,2904,8,1,27,0,5,15,15,0,0,0,0,2960,30,2930,2960,1283,1677,2904,42,423000
42,3,424000,1258956,3594,1911,1911,0,1911,1748,163,3594,3594,0,0,3594,3545,3369,137,1,23,2,13,49,39,7,0,3,0,3594,76,3518,3594,1619,1975,3369,42,424000
42,3,425000,1934076,3924,1934,1934,0,1934,1749,185,3924,3924,0,0,3924,3893,3837,30,14,6,0,6,31,31,0,0,0,0,3924,45,3879,3924,1849,2075,3837,42,425000
42,3,426300,5280924,6194,2467,2467,0,2467,2420,47,6194,6194,0,0,6194,6174,6121,23,3,23,2,2,20,15,5,0,0,0,6194,23,6171,6194,2993,3201,6121,42,426300
42,3,426400,3515805,4819,2141,2141,0,2141,2064,77,4819,4819,0,0,4819,4799,4739,30,5,17,0,8,20,19,1,0,0,0,4819,26,4793,4819,2221,2598,4739,42,426400
42,3,426700,3652203,2664,1260,1260,0,1260,1179,81,2664,2664,0,0,2664,2620,2484,16,1,115,0,4,44,42,2,0,0,0,2664,21,2643,2664,1274,1390,2484,42,426700
42,3,426800,5219461,5295,1942,1942,0,1942,1905,37,5295,5295,0,0,5295,5264,5210,11,1,39,1,2,31,31,0,0,0,0,5295,28,5267,5295,2615,2680,5210,42,426800
42,3,427000,1686168,4028,2085,2085,0,2085,1839,246,4028,4028,0,0,4028,3988,3907,39,8,7,0,27,40,33,7,0,0,0,4028,36,3992,4028,1969,2059,3907,42,427000
42,3,427100,6156053,5605,2161,2161,0,2161,2120,41,5605,5605,0,0,5605,5582,5498,17,1,50,4,12,23,23,0,0,0,0,5605,34,5571,5605,2699,2906,5498,42,427100
42,3,427200,4682393,5180,2363,2363,0,2363,2244,119,5180,5180,0,0,5180,5150,5087,25,7,24,0,7,30,25,5,0,0,0,5180,23,5157,5180,2391,2789,5087,42,427200
42,3,428100,874863,1424,602,602,0,602,576,26,1424,1424,0,0,1424,1421,1401,11,7,1,0,1,3,3,0,0,0,0,1424,2,1422,1424,697,727,1401,42,428100
42,3,428200,4288310,2432,1003,1003,0,1003,971,32,2432,2432,0,0,2432,2430,2374,41,0,10,0,5,2,2,0,0,0,0,2432,15,2417,2432,1168,1264,2374,42,428200
42,3,429100,5796580,2814,1158,1158,0,1158,1131,27,2814,2814,0,0,2814,2800,2699,54,2,36,0,9,14,13,1,0,0,0,2814,17,2797,2814,1283,1531,2699,42,429100
42,3,429201,4682453,4463,1742,1742,0,1742,1651,91,4463,4463,0,0,4463,4444,4157,68,3,206,3,7,19,19,0,0,0,0,4463,42,4421,4463,2110,2353,4157,42,429201
42,3,429202,4363952,4674,1976,1976,0,1976,1929,47,4674,4674,0,0,4674,4636,4483,42,4,94,0,13,38,34,4,0,0,0,4674,37,4637,4674,2235,2439,4483,42,429202
42,3,429300,8393878,5889,2560,2560,0,2560,2495,65,5889,5889,0,0,5889,5875,5788,33,5,41,5,3,14,14,0,0,0,0,5889,34,5855,5889,2722,3167,5788,42,429300
42,3,429400,3540257,4618,1984,1984,0,1984,1920,64,4618,4618,0,0,4618,4597,4544,25,1,14,4,9,21,19,1,0,1,0,4618,19,4599,4618,2170,2448,4544,42,429400
42,3,429500,4109168,4274,2418,2418,0,2418,2297,121,4274,4274,0,0,4274,4244,3989,87,5,151,4,8,30,27,2,1,0,0,4274,41,4233,4274,1948,2326,3989,42,429500
42,3,429600,3388980,3397,1539,1539,0,1539,1467,72,3397,3397,0,0,3397,3373,3185,137,7,27,5,12,24,18,6,0,0,0,3397,37,3360,3397,1563,1834,3185,42,429600
42,3,429700,3106085,2422,1045,1045,0,1045,1002,43,2422,2422,0,0,2422,2418,2380,17,0,17,0,4,4,4,0,0,0,0,2422,10,2412,2422,1138,1284,2380,42,429700
42,3,430100,856511,2345,1057,1057,0,1057,995,62,2345,2345,0,0,2345,2327,2283,29,0,12,0,3,18,18,0,0,0,0,2345,10,2335,2345,1116,1229,2283,42,430100
42,3,430200,1757270,4932,2247,2247,0,2247,2154,93,4932,4932,0,0,4932,4901,4821,39,5,26,0,10,31,27,4,0,0,0,4932,29,4903,4932,2296,2636,4821,42,430200
42,3,431100,934380,3555,1889,1889,0,1889,1725,164,3555,3555,0,0,3555,3496,3290,172,6,21,0,7,59,56,2,1,0,0,3555,33,3522,3555,1594,1961,3290,42,431100
42,3,431400,680137,1822,958,958,0,958,900,58,1822,1822,0,0,1822,1803,1729,62,5,6,0,1,19,18,1,0,0,0,1822,10,1812,1822,797,1025,1729,42,431400
42,3,431500,976036,3393,1923,1923,0,1923,1764,159,3393,3393,0,0,3393,3361,3169,152,4,30,0,6,32,28,4,0,0,0,3393,28,3365,3393,1525,1868,3169,42,431500
42,3,432300,902126,2317,1327,1327,0,1327,1232,95,2317,2317,0,0,2317,2287,2153,122,2,8,0,2,30,29,1,0,0,0,2317,15,2302,2317,1028,1289,2153,42,432300
42,3,432400,728407,2977,1518,1518,0,1518,1397,121,2977,2977,0,0,2977,2933,2772,135,3,16,1,6,44,38,6,0,0,0,2977,16,2961,2977,1398,1579,2772,42,432400
42,3,433000,435961,392,144,144,0,144,138,6,392,392,0,0,392,389,387,1,0,1,0,0,3,3,0,0,0,0,392,3,389,392,203,189,387,42,433000
42,3,434000,1033269,1917,825,825,0,825,784,41,1917,1917,0,0,1917,1899,1839,47,7,5,0,1,18,17,1,0,0,0,1917,9,1908,1917,893,1024,1839,42,434000
42,3,435000,1488979,2598,1228,1228,0,1228,1153,75,2598,2598,0,0,2598,2578,2453,93,1,30,0,1,20,20,0,0,0,0,2598,11,2587,2598,1309,1289,2453,42,435000
42,3,436000,6589633,723,318,318,0,318,310,8,723,723,0,0,723,720,715,4,0,1,0,0,3,2,1,0,0,0,723,1,722,723,370,353,715,42,436000
42,3,437000,17764557,3086,1177,1177,0,1177,1106,71,3086,3086,0,0,3086,3071,2992,26,2,46,2,3,15,14,1,0,0,0,3086,14,3072,3086,1543,1543,2992,42,437000
42,3,438000,6449565,652,231,231,0,231,225,6,652,652,0,0,652,648,615,16,0,12,0,5,4,2,2,0,0,0,652,11,641,652,331,321,615,42,438000
42,3,439000,13493570,1382,540,540,0,540,520,20,1382,1382,0,0,1382,1371,1322,15,9,21,0,4,11,10,1,0,0,0,1382,3,1379,1382,683,699,1322,42,439000
42,3,440000,18972275,981,355,355,0,355,336,19,981,981,0,0,981,972,955,9,0,6,0,2,9,9,0,0,0,0,981,3,978,981,419,562,955,42,440000
42,3,441000,4692271,1039,509,509,0,509,483,26,1039,1039,0,0,1039,1036,992,32,0,11,0,1,3,3,0,0,0,0,1039,10,1029,1039,494,545,992,42,441000
42,3,442000,2193311,236,96,96,0,96,90,6,236,236,0,0,236,235,227,6,2,0,0,0,1,1,0,0,0,0,236,1,235,236,113,123,227,42,442000
42,3,443000,519312,78,38,38,0,38,36,2,78,78,0,0,78,76,76,0,0,0,0,0,2,2,0,0,0,0,78,0,78,78,38,40,76,42,443000
42,3,444000,1160775,566,222,222,0,222,216,6,566,566,0,0,566,565,555,9,0,0,0,1,1,1,0,0,0,0,566,2,564,566,269,297,555,42,444000
42,3,445500,2482377,3902,2037,2037,0,2037,1891,146,3902,3902,0,0,3902,3859,3442,376,5,33,1,2,43,38,5,0,0,0,3902,42,3860,3902,1732,2170,3442,42,445500
42,3,446000,3952533,1730,671,671,0,671,644,27,1730,1730,0,0,1730,1716,1658,34,6,16,1,1,14,11,3,0,0,0,1730,15,1715,1730,813,917,1658,42,446000
42,3,447000,4127429,1568,599,599,0,599,569,30,1568,1568,0,0,1568,1549,1487,42,0,15,0,5,19,15,1,0,3,0,1568,12,1556,1568,752,816,1487,42,447000
42,3,448000,2560816,1232,653,653,0,653,576,77,1232,1232,0,0,1232,1197,1099,90,0,0,0,8,35,30,5,0,0,0,1232,20,1212,1232,549,683,1099,42,448000
42,3,449000,5371094,2314,920,920,0,920,886,34,2314,2314,0,0,2314,2308,2250,29,7,21,1,0,6,6,0,0,0,0,2314,18,2296,2314,1119,1195,2250,42,449000
42,3,450700,2062539,3402,1670,1670,0,1670,1562,108,3402,3402,0,0,3402,3354,3127,206,3,10,0,8,48,45,3,0,0,0,3402,25,3377,3402,1549,1853,3127,42,450700
42,3,450800,1402807,2729,1449,1449,0,1449,1318,131,2729,2729,0,0,2729,2675,2082,556,2,7,1,27,54,48,6,0,0,0,2729,35,2694,2729,1251,1478,2082,42,450800
42,3,451101,7381645,3591,1458,1458,0,1458,1402,56,3591,3591,0,0,3591,3570,3441,68,0,51,0,10,21,18,3,0,0,0,3591,39,3552,3591,1725,1866,3441,42,451101
42,3,451102,5940863,5573,2190,2190,0,2190,2029,161,5573,5573,0,0,5573,5480,4913,420,9,119,4,15,93,74,19,0,0,0,5573,56,5517,5573,2835,2738,4913,42,451102
42,3,451103,17152698,7178,3247,3247,0,3247,2785,462,7178,7178,0,0,7178,7126,6707,203,5,194,1,16,52,51,1,0,0,0,7178,66,7112,7178,3544,3634,6707,42,451103
42,3,451300,31002648,5948,2305,2305,0,2305,2229,76,5948,5948,0,0,5948,5898,5707,107,0,69,0,15,50,49,1,0,0,0,5948,59,5889,5948,2890,3058,5707,42,451300
42,3,452000,84409025,5145,2128,2128,0,2128,2028,100,5145,5145,0,0,5145,5100,4948,84,7,57,0,4,45,42,3,0,0,0,5145,29,5116,5145,2525,2620,4948,42,452000
42,3,453001,22858995,8416,3697,3697,0,3697,3494,203,8416,8416,0,0,8416,8365,7786,250,13,301,0,15,51,42,9,0,0,0,8416,88,8328,8416,4127,4289,7786,42,453001
42,3,453002,42101277,3838,1596,1596,0,1596,1510,86,3838,3838,0,0,3838,3815,3732,69,2,6,1,5,23,19,4,0,0,0,3838,20,3818,3838,1895,1943,3732,42,453002
42,3,454000,528241,415,180,180,0,180,171,9,415,415,0,0,415,412,389,22,0,1,0,0,3,3,0,0,0,0,415,0,415,415,197,218,389,42,454000
42,3,455000,1358948,1551,640,640,0,640,604,36,1551,1551,0,0,1551,1545,1523,14,1,1,0,6,6,6,0,0,0,0,1551,11,1540,1551,748,803,1523,42,455000
42,3,456001,14416713,3082,1175,1175,0,1175,1121,54,3082,3082,0,0,3082,3072,2996,36,1,36,1,2,10,10,0,0,0,0,3082,14,3068,3082,1526,1556,2996,42,456001
42,3,456003,31582650,4169,1806,1806,0,1806,1728,78,4169,4169,0,0,4169,4148,3990,95,1,45,0,17,21,21,0,0,0,0,4169,25,4144,4169,1964,2205,3990,42,456003
42,3,456004,6686797,5020,1943,1943,0,1943,1855,88,5020,5020,0,0,5020,4975,4540,298,0,114,5,18,45,40,3,2,0,0,5020,49,4971,5020,2334,2686,4540,42,456004
42,3,457100,937947,1580,828,828,0,828,792,36,1580,1580,0,0,1580,1573,1498,60,0,5,0,10,7,5,2,0,0,0,1580,15,1565,1580,728,852,1498,42,457100
42,3,457200,1863123,3761,1828,1828,0,1828,1747,81,3761,3761,0,0,3761,3729,3525,176,5,15,0,8,32,25,7,0,0,0,3761,26,3735,3761,1756,2005,3525,42,457200
42,3,458000,36753732,5265,2358,2358,0,2358,2224,134,5265,5265,0,0,5265,5239,5163,39,0,26,0,11,26,21,4,1,0,0,5265,19,5246,5265,2520,2745,5163,42,458000
42,3,459101,6016422,1779,731,731,0,731,685,46,1779,1779,0,0,1779,1765,1672,79,1,11,0,2,14,14,0,0,0,0,1779,10,1769,1779,893,886,1672,42,459101
42,3,459102,9461939,5096,1733,1733,0,1733,1699,34,5096,5096,0,0,5096,5069,4961,52,2,53,0,1,27,27,0,0,0,0,5096,32,5064,5096,2499,2597,4961,42,459102
42,3,459201,22722143,5414,2694,2694,0,2694,2444,250,5414,5414,0,0,5414,5383,5072,103,4,187,3,14,31,30,1,0,0,0,5414,48,5366,5414,2652,2762,5072,42,459201
42,3,459202,150383,738,500,500,0,500,491,9,738,738,0,0,738,733,708,12,6,6,0,1,5,5,0,0,0,0,738,6,732,738,299,439,708,42,459202
42,3,460001,6779100,4176,1776,1776,0,1776,1739,37,4176,4176,0,0,4176,4168,4134,13,0,18,2,1,8,8,0,0,0,0,4176,16,4160,4176,1934,2242,4134,42,460001
42,3,460002,7322052,3328,1204,1204,0,1204,1178,26,3328,3328,0,0,3328,3314,3268,25,1,18,0,2,14,12,2,0,0,0,3328,6,3322,3328,1650,1678,3268,42,460002
42,3,461000,3433213,1232,676,676,0,676,624,52,1232,1232,0,0,1232,1219,1199,15,1,0,0,4,13,11,2,0,0,0,1232,11,1221,1232,600,632,1199,42,461000
42,3,462100,4059617,2637,1444,1444,0,1444,1196,248,2637,2637,0,0,2637,2612,2291,308,2,8,0,3,25,24,1,0,0,0,2637,17,2620,2637,1243,1394,2291,42,462100
42,3,462600,1061745,4069,2112,2112,0,2112,1865,247,4069,4069,0,0,4069,4032,3774,231,12,3,0,12,37,37,0,0,0,0,4069,11,4058,4069,1895,2174,3774,42,462600
42,3,463900,989907,2892,1451,1451,0,1451,1276,175,2892,2892,0,0,2892,2862,2678,162,1,16,0,5,30,30,0,0,0,0,2892,33,2859,2892,1361,1531,2678,42,463900
42,3,464300,1127732,3712,1650,1650,0,1650,1565,85,3712,3712,0,0,3712,3692,3542,114,8,20,0,8,20,20,0,0,0,0,3712,21,3691,3712,1740,1972,3542,42,464300
42,3,464400,1699390,3730,1951,1951,0,1951,1629,322,3730,3730,0,0,3730,3637,2799,769,16,29,2,22,93,86,7,0,0,0,3730,39,3691,3730,1759,1971,2799,42,464400
42,3,465600,967980,2826,1540,1540,0,1540,1382,158,2826,2826,0,0,2826,2793,2642,109,6,28,4,4,33,26,7,0,0,0,2826,9,2817,2826,1321,1505,2642,42,465600
42,3,465800,1967863,3880,1804,1804,0,1804,1697,107,3880,3880,0,0,3880,3857,3762,75,1,12,1,6,23,20,3,0,0,0,3880,29,3851,3880,1858,2022,3762,42,465800
42,3,466000,1142616,468,182,182,0,182,177,5,468,468,0,0,468,458,453,0,0,4,0,1,10,10,0,0,0,0,468,7,461,468,228,240,453,42,466000
42,3,467000,1565526,464,193,193,0,193,185,8,464,464,0,0,464,463,460,3,0,0,0,0,1,1,0,0,0,0,464,2,462,464,231,233,460,42,467000
42,3,468700,1420691,1984,906,906,0,906,853,53,1984,1984,0,0,1984,1972,1894,66,0,9,0,3,12,12,0,0,0,0,1984,5,1979,1984,926,1058,1894,42,468700
42,3,468800,1107988,2365,1220,1220,0,1220,1127,93,2365,2365,0,0,2365,2349,2208,99,5,22,0,15,16,14,2,0,0,0,2365,24,2341,2365,1122,1243,2208,42,468800
42,3,468900,1751123,4040,2123,2123,0,2123,1987,136,4040,4040,0,0,4040,3954,3559,302,2,72,4,15,86,76,10,0,0,0,4040,54,3986,4040,1807,2233,3559,42,468900
42,3,469000,5437629,4719,2026,2026,0,2026,1974,52,4719,4719,0,0,4719,4659,4540,25,0,92,0,2,60,60,0,0,0,0,4719,31,4688,4719,2251,2468,4540,42,469000
42,3,470300,3527702,3805,1583,1583,0,1583,1539,44,3805,3805,0,0,3805,3794,3672,42,1,74,0,5,11,10,1,0,0,0,3805,27,3778,3805,1698,2107,3672,42,470300
42,3,470400,1820866,3461,1456,1456,0,1456,1424,32,3461,3461,0,0,3461,3443,3392,15,2,29,2,3,18,18,0,0,0,0,3461,15,3446,3461,1584,1877,3392,42,470400
42,3,470500,3001216,6643,3421,3421,0,3421,3276,145,6643,6643,0,0,6643,6527,5465,95,10,935,0,22,116,115,1,0,0,0,6643,48,6595,6643,3218,3425,5465,42,470500
42,3,470600,1941671,3379,1703,1703,0,1703,1596,107,3379,3379,0,0,3379,3349,3263,46,1,29,0,10,30,29,1,0,0,0,3379,27,3352,3379,1636,1743,3263,42,470600
42,3,471000,681671,1225,606,606,0,606,571,35,1225,1225,0,0,1225,1214,1196,12,0,3,0,3,11,11,0,0,0,0,1225,7,1218,1225,571,654,1196,42,471000
42,3,472100,530825,2755,1313,1313,0,1313,1241,72,2755,2755,0,0,2755,2718,2599,42,7,60,1,9,37,32,5,0,0,0,2755,36,2719,2755,1272,1483,2599,42,472100
42,3,472200,640793,2390,1112,1112,0,1112,1065,47,2390,2390,0,0,2390,2379,2331,22,3,18,4,1,11,6,5,0,0,0,2390,20,2370,2390,1141,1249,2331,42,472200
42,3,472300,338346,2203,1059,1059,0,1059,998,61,2203,2203,0,0,2203,2190,2099,32,3,49,0,7,13,13,0,0,0,0,2203,29,2174,2203,1033,1170,2099,42,472300
42,3,472400,408306,1957,803,803,0,803,785,18,1957,1957,0,0,1957,1942,1911,2,3,25,0,1,15,15,0,0,0,0,1957,14,1943,1957,945,1012,1911,42,472400
42,3,473100,1540194,4964,2389,2389,0,2389,2267,122,4964,4964,0,0,4964,4924,4770,37,7,90,0,20,40,40,0,0,0,0,4964,41,4923,4964,2323,2641,4770,42,473100
42,3,473200,742886,3432,1832,1832,0,1832,1752,80,3432,3432,0,0,3432,3409,3255,26,7,113,0,8,23,23,0,0,0,0,3432,34,3398,3432,1523,1909,3255,42,473200
42,3,473300,3315634,5477,2153,2153,0,2153,2101,52,5477,5477,0,0,5477,5434,5353,26,2,46,0,7,43,40,3,0,0,0,5477,36,5441,5477,2550,2927,5353,42,473300
42,3,473401,1501460,3768,1663,1663,0,1663,1606,57,3768,3768,0,0,3768,3743,3593,19,0,121,1,9,25,22,3,0,0,0,3768,35,3733,3768,1803,1965,3593,42,473401
42,3,473402,1682982,3681,1481,1481,0,1481,1434,47,3681,3681,0,0,3681,3658,3523,22,0,105,1,7,23,23,0,0,0,0,3681,37,3644,3681,1756,1925,3523,42,473402
42,3,473500,2354216,3619,1319,1319,0,1319,1288,31,3619,3619,0,0,3619,3597,3517,24,3,50,1,2,22,20,2,0,0,0,3619,43,3576,3619,1678,1941,3517,42,473500
42,3,473601,2127728,3839,1363,1363,0,1363,1333,30,3839,3839,0,0,3839,3826,3691,34,1,97,1,2,13,13,0,0,0,0,3839,26,3813,3839,1749,2090,3691,42,473601
42,3,473602,2404653,4237,1889,1889,0,1889,1829,60,4237,4237,0,0,4237,4222,4064,14,3,135,0,6,15,15,0,0,0,0,4237,11,4226,4237,1988,2249,4064,42,473602
42,3,474101,4002305,3800,1403,1403,0,1403,1371,32,3800,3800,0,0,3800,3760,3565,44,1,148,0,2,40,40,0,0,0,0,3800,30,3770,3800,1837,1963,3565,42,474101
42,3,474102,4653091,3502,1281,1281,0,1281,1248,33,3502,3502,0,0,3502,3487,3350,15,2,120,0,0,15,15,0,0,0,0,3502,36,3466,3502,1710,1792,3350,42,474102
42,3,474201,3239086,2630,907,907,0,907,897,10,2630,2630,0,0,2630,2621,2508,21,0,88,0,4,9,9,0,0,0,0,2630,15,2615,2630,1284,1346,2508,42,474201
42,3,474202,8885853,5368,1881,1881,0,1881,1853,28,5368,5368,0,0,5368,5334,5100,32,1,191,4,6,34,31,3,0,0,0,5368,46,5322,5368,2494,2874,5100,42,474202
42,3,474203,4484600,4753,1619,1619,0,1619,1597,22,4753,4753,0,0,4753,4727,4439,24,1,259,1,3,26,26,0,0,0,0,4753,30,4723,4753,2376,2377,4439,42,474203
42,3,475101,3139162,5037,2541,2541,0,2541,2400,141,5037,5037,0,0,5037,4988,4796,77,2,106,4,3,49,42,7,0,0,0,5037,18,5019,5037,2218,2819,4796,42,475101
42,3,475102,1790795,1909,704,704,0,704,695,9,1909,1909,0,0,1909,1892,1844,33,0,13,0,2,17,15,2,0,0,0,1909,7,1902,1909,952,957,1844,42,475102
42,3,475200,4770163,5080,2026,2026,0,2026,1971,55,5080,5080,0,0,5080,5055,4985,26,2,35,1,6,25,24,1,0,0,0,5080,28,5052,5080,2478,2602,4985,42,475200
42,3,475301,3425761,4590,2166,2166,0,2166,2032,134,4590,4590,0,0,4590,4561,4427,98,1,26,2,7,29,28,1,0,0,0,4590,24,4566,4590,2152,2438,4427,42,475301
42,3,475303,3098361,4291,1552,1552,0,1552,1520,32,4291,4291,0,0,4291,4284,4214,20,0,43,2,5,7,7,0,0,0,0,4291,17,4274,4291,2090,2201,4214,42,475303
42,3,475304,4350244,5828,2201,2201,0,2201,2131,70,5828,5828,0,0,5828,5792,5606,56,4,114,0,12,36,32,4,0,0,0,5828,39,5789,5828,2834,2994,5606,42,475304
42,3,475401,5867012,3719,1510,1510,0,1510,1483,27,3719,3719,0,0,3719,3714,3675,20,1,9,0,9,5,4,1,0,0,0,3719,21,3698,3719,1786,1933,3675,42,475401
42,3,475402,3842956,3102,1171,1171,0,1171,1130,41,3102,3102,0,0,3102,3076,3037,13,0,25,0,1,26,23,3,0,0,0,3102,10,3092,3102,1559,1543,3037,42,475402
42,3,476100,2478624,5083,2525,2525,0,2525,2403,122,5083,5083,0,0,5083,5055,4878,87,2,63,1,24,28,27,1,0,0,0,5083,60,5023,5083,2384,2699,4878,42,476100
42,3,476200,1734415,3473,1512,1512,0,1512,1456,56,3473,3473,0,0,3473,3458,3414,28,3,4,0,9,15,15,0,0,0,0,3473,24,3449,3473,1670,1803,3414,42,476200
42,3,477100,2119053,3694,1554,1554,0,1554,1516,38,3694,3694,0,0,3694,3690,3678,4,0,8,0,0,4,4,0,0,0,0,3694,12,3682,3694,1675,2019,3678,42,477100
42,3,477200,2889061,4456,2066,2066,0,2066,2012,54,4456,4456,0,0,4456,4444,4408,14,0,12,0,10,12,9,2,1,0,0,4456,28,4428,4456,1985,2471,4408,42,477200
42,3,477300,3498376,6294,2899,2899,0,2899,2766,133,6294,6294,0,0,6294,6203,5867,187,3,114,2,30,91,89,2,0,0,0,6294,56,6238,6294,3048,3246,5867,42,477300
42,3,478100,1521400,4407,2204,2204,0,2204,2086,118,4407,4407,0,0,4407,4386,4299,36,7,32,0,12,21,20,1,0,0,0,4407,24,4383,4407,2083,2324,4299,42,478100
42,3,478200,2224065,6059,2691,2691,0,2691,2572,119,6059,6059,0,0,6059,6026,5952,20,18,25,1,10,33,31,2,0,0,0,6059,48,6011,6059,2895,3164,5952,42,478200
42,3,479000,1400826,2244,880,880,0,880,869,11,2244,2244,0,0,2244,2235,2213,6,0,13,0,3,9,7,2,0,0,0,2244,9,2235,2244,1055,1189,2213,42,479000
42,3,480101,2286676,4562,2338,2338,0,2338,1841,497,4562,4562,0,0,4562,4492,4098,319,4,44,0,27,70,69,1,0,0,0,4562,61,4501,4562,2094,2468,4098,42,480101
42,3,480102,1646466,3297,1368,1368,0,1368,1339,29,3297,3297,0,0,3297,3289,3173,80,1,31,1,3,8,6,2,0,0,0,3297,6,3291,3297,1567,1730,3173,42,480102
42,3,480200,3075267,3498,1465,1465,0,1465,1414,51,3498,3498,0,0,3498,3486,3448,17,2,18,0,1,12,9,3,0,0,0,3498,22,3476,3498,1687,1811,3448,42,480200
42,3,480300,2919220,3321,1430,1430,0,1430,1382,48,3321,3321,0,0,3321,3315,3293,9,0,13,0,0,6,6,0,0,0,0,3321,13,3308,3321,1596,1725,3293,42,480300
42,3,480400,5018849,5321,2282,2282,0,2282,2217,65,5321,5321,0,0,5321,5296,5227,58,2,6,0,3,25,21,4,0,0,0,5321,27,5294,5321,2534,2787,5227,42,480400
42,3,481000,877326,3970,1864,1864,0,1864,1681,183,3970,3970,0,0,3970,3893,3325,466,9,65,1,27,77,74,3,0,0,0,3970,43,3927,3970,1895,2075,3325,42,481000
42,3,482500,2362162,2197,1106,1106,0,1106,956,150,2197,2197,0,0,2197,2178,1967,194,4,12,0,1,19,18,1,0,0,0,2197,12,2185,2197,1032,1165,1967,42,482500
42,3,483800,1471555,3569,2071,2071,0,2071,1607,464,3569,3569,0,0,3569,3472,1522,1831,9,101,1,8,97,94,3,0,0,0,3569,22,3547,3569,1587,1982,1522,42,483800
42,3,484300,2164691,3475,1735,1735,0,1735,1538,197,3475,3475,0,0,3475,3426,3039,332,1,39,0,15,49,43,6,0,0,0,3475,33,3442,3475,1652,1823,3039,42,484300
42,3,484500,2546294,6263,2920,2920,0,2920,2769,151,6263,6263,0,0,6263,6240,6185,16,0,24,0,15,23,19,4,0,0,0,6263,43,6220,6263,2877,3386,6185,42,484500
42,3,484600,1269481,2526,1125,1125,0,1125,1057,68,2526,2526,0,0,2526,2485,2400,67,1,12,0,5,41,29,10,2,0,0,2526,22,2504,2526,1105,1421,2400,42,484600
42,3,485000,782793,1338,620,620,0,620,560,60,1338,1338,0,0,1338,1328,1253,67,0,0,0,8,10,9,1,0,0,0,1338,7,1331,1338,673,665,1253,42,485000
42,3,486700,2493404,2835,1504,1504,0,1504,1294,210,2835,2835,0,0,2835,2755,1503,1232,1,0,1,18,80,68,12,0,0,0,2835,34,2801,2835,1228,1607,1503,42,486700
42,3,486800,1278258,2174,1112,1112,0,1112,920,192,2174,2174,0,0,2174,2141,1174,950,0,7,0,10,33,31,2,0,0,0,2174,11,2163,2174,968,1206,1174,42,486800
42,3,486900,934557,2323,1152,1152,0,1152,965,187,2323,2323,0,0,2323,2268,910,1319,10,3,0,26,55,54,1,0,0,0,2323,8,2315,2323,1070,1253,910,42,486900
42,3,487000,2633436,2015,1021,1021,0,1021,948,73,2015,2015,0,0,2015,2009,1989,10,5,0,0,5,6,6,0,0,0,0,2015,12,2003,2015,920,1095,1989,42,487000
42,3,488100,1669701,2449,1063,1063,0,1063,1003,60,2449,2449,0,0,2449,2419,2003,398,2,4,3,9,30,22,8,0,0,0,2449,6,2443,2449,1212,1237,2003,42,488100
42,3,488200,2921060,3848,1609,1609,0,1609,1540,69,3848,3848,0,0,3848,3802,2873,906,12,6,0,5,46,37,9,0,0,0,3848,16,3832,3848,1732,2116,2873,42,488200
42,3,488300,6204765,2327,998,998,0,998,957,41,2327,2327,0,0,2327,2320,2299,18,0,2,0,1,7,7,0,0,0,0,2327,13,2314,2327,1116,1211,2299,42,488300
42,3,488400,3575609,4903,2318,2318,0,2318,2227,91,4903,4903,0,0,4903,4864,4612,231,1,7,1,12,39,37,2,0,0,0,4903,16,4887,4903,2214,2689,4612,42,488400
42,3,488500,9630247,3248,1491,1491,0,1491,1427,64,3248,3248,0,0,3248,3233,3147,59,1,15,0,11,15,14,1,0,0,0,3248,27,3221,3248,1617,1631,3147,42,488500
42,3,488600,12678928,5689,2487,2487,0,2487,2355,132,5689,5689,0,0,5689,5638,5203,375,10,22,9,19,51,50,0,1,0,0,5689,49,5640,5689,2710,2979,5203,42,488600
42,3,489001,3610232,4373,1972,1972,0,1972,1879,93,4373,4373,0,0,4373,4359,4242,52,2,52,0,11,14,14,0,0,0,0,4373,19,4354,4373,2029,2344,4242,42,489001
42,3,489002,3439895,4024,1600,1600,0,1600,1543,57,4024,4024,0,0,4024,4007,3907,58,2,38,1,1,17,17,0,0,0,0,4024,11,4013,4024,1991,2033,3907,42,489002
42,3,490002,8042512,5565,2456,2456,0,2456,2345,111,5565,5565,0,0,5565,5525,5150,315,8,40,0,12,40,35,5,0,0,0,5565,36,5529,5565,2732,2833,5150,42,490002
42,3,490003,7621618,3558,1467,1467,0,1467,1407,60,3558,3558,0,0,3558,3541,3484,27,0,26,4,0,17,14,3,0,0,0,3558,14,3544,3558,1755,1803,3484,42,490003
42,3,490004,8088654,5217,1693,1693,0,1693,1670,23,5217,5217,0,0,5217,5180,5011,118,1,43,2,5,37,36,1,0,0,0,5217,29,5188,5217,2545,2672,5011,42,490004
42,3,491101,16833822,5132,2006,2006,0,2006,1914,92,5132,5132,0,0,5132,5104,4929,72,13,81,0,9,28,24,4,0,0,0,5132,48,5084,5132,2463,2669,4929,42,491101
42,3,491102,15722650,2298,955,955,0,955,915,40,2298,2298,0,0,2298,2290,2255,27,2,4,0,2,8,8,0,0,0,0,2298,11,2287,2298,1134,1164,2255,42,491102
42,3,491200,10349447,2236,993,993,0,993,952,41,2236,2236,0,0,2236,2221,2169,28,1,20,0,3,15,15,0,0,0,0,2236,8,2228,2236,1026,1210,2169,42,491200
42,3,492700,3887501,2533,1225,1225,0,1225,1075,150,2533,2533,0,0,2533,2506,2239,252,3,7,0,5,27,24,3,0,0,0,2533,17,2516,2533,1215,1318,2239,42,492700
42,3,492800,1627633,3117,1638,1638,0,1638,1328,310,3117,3117,0,0,3117,3054,1345,1695,3,1,0,10,63,58,3,1,0,1,3117,27,3090,3117,1359,1758,1345,42,492800
42,3,492900,1642996,2841,1487,1487,0,1487,1307,180,2841,2841,0,0,2841,2761,2285,458,3,6,0,9,80,74,5,1,0,0,2841,18,2823,2841,1294,1547,2285,42,492900
42,3,493000,529323,565,279,279,0,279,247,32,565,565,0,0,565,564,561,1,0,2,0,0,1,1,0,0,0,0,565,0,565,565,262,303,561,42,493000
42,3,494000,916937,1609,758,758,0,758,681,77,1609,1609,0,0,1609,1593,1526,58,6,3,0,0,16,16,0,0,0,0,1609,4,1605,1609,726,883,1526,42,494000
42,3,495000,49016456,3771,1616,1616,0,1616,1485,131,3771,3771,0,0,3771,3743,3681,41,5,12,1,3,28,24,4,0,0,0,3771,12,3759,3771,1832,1939,3681,42,495000
42,3,496101,11625872,3257,1222,1222,0,1222,1183,39,3257,3257,0,0,3257,3243,3202,33,0,3,0,5,14,12,2,0,0,0,3257,6,3251,3257,1545,1712,3202,42,496101
42,3,496102,32470253,4582,1930,1930,0,1930,1859,71,4582,4582,0,0,4582,4559,4397,135,1,15,2,9,23,18,0,0,0,5,4582,12,4570,4582,2194,2388,4397,42,496102
42,3,496200,14320160,6000,2526,2526,0,2526,2425,101,6000,6000,0,0,6000,5973,5874,66,5,18,0,10,27,27,0,0,0,0,6000,33,5967,6000,2902,3098,5874,42,496200
42,3,497000,12426823,1218,506,506,0,506,484,22,1218,1218,0,0,1218,1216,1203,8,1,4,0,0,2,2,0,0,0,0,1218,9,1209,1218,584,634,1203,42,497000
42,3,498000,3724465,2670,1162,1162,0,1162,1125,37,2670,2670,0,0,2670,2662,2616,39,3,3,1,0,8,7,1,0,0,0,2670,10,2660,2670,1255,1415,2616,42,498000
42,3,499300,2178306,1729,796,796,0,796,746,50,1729,1729,0,0,1729,1715,1695,10,2,3,3,2,14,10,3,0,1,0,1729,16,1713,1729,823,906,1695,42,499300
42,3,499400,2178066,3264,1609,1609,0,1609,1441,168,3264,3264,0,0,3264,3253,3210,18,12,6,0,7,11,10,1,0,0,0,3264,25,3239,3264,1525,1739,3210,42,499400
42,3,500300,2838084,4228,1940,1940,0,1940,1826,114,4228,4228,0,0,4228,4212,4175,29,1,1,1,5,16,16,0,0,0,0,4228,32,4196,4228,2027,2201,4175,42,500300
42,3,501000,1271713,1724,937,937,0,937,852,85,1724,1724,0,0,1724,1707,1653,44,3,6,0,1,17,16,1,0,0,0,1724,13,1711,1724,768,956,1653,42,501000
42,3,502000,2230371,351,162,162,0,162,151,11,351,351,0,0,351,351,351,0,0,0,0,0,0,0,0,0,0,0,351,1,350,351,174,177,351,42,502000
42,3,503001,11840085,2007,910,910,0,910,877,33,2007,2007,0,0,2007,1998,1957,35,0,4,0,2,9,9,0,0,0,0,2007,6,2001,2007,973,1034,1957,42,503001
42,3,503002,5419117,6425,2909,2909,0,2909,2799,110,6425,6425,0,0,6425,6397,6239,122,1,26,1,8,28,27,1,0,0,0,6425,28,6397,6425,3014,3411,6239,42,503002
42,3,504100,8776817,5746,2701,2701,0,2701,2541,160,5746,5746,0,0,5746,5627,4641,935,4,28,2,17,119,109,10,0,0,0,5746,34,5712,5746,2624,3122,4641,42,504100
42,3,504400,12225467,5379,2526,2526,0,2526,2392,134,5379,5379,0,0,5379,5348,5128,152,3,57,1,7,31,28,3,0,0,0,5379,20,5359,5379,2626,2753,5128,42,504400
42,3,505000,465786,31,10,10,0,10,10,0,31,31,0,0,31,31,31,0,0,0,0,0,0,0,0,0,0,0,31,0,31,31,15,16,31,42,505000
42,3,506000,1147420,727,363,363,0,363,324,39,727,727,0,0,727,723,707,15,0,1,0,0,4,4,0,0,0,0,727,2,725,727,345,382,707,42,506000
42,3,507000,1020241,2343,1154,1154,0,1154,1078,76,2343,2343,0,0,2343,2318,2241,67,3,3,0,4,25,22,3,0,0,0,2343,16,2327,2343,1121,1222,2241,42,507000
42,3,508000,1159901,2145,1199,1199,0,1199,1032,167,2145,2145,0,0,2145,2110,1959,136,3,5,0,7,35,33,2,0,0,0,2145,27,2118,2145,972,1173,1959,42,508000
42,3,509400,2536077,6076,2969,2969,0,2969,2717,252,6076,6076,0,0,6076,5998,5633,314,5,37,0,9,78,76,2,0,0,0,6076,37,6039,6076,2726,3350,5633,42,509400
42,3,510000,1011712,2017,1107,1107,0,1107,936,171,2017,2017,0,0,2017,1973,1535,422,7,2,1,6,44,40,4,0,0,0,2017,10,2007,2017,888,1129,1535,42,510000
42,3,511000,409792,870,449,449,0,449,407,42,870,870,0,0,870,858,813,33,2,6,1,3,12,10,1,1,0,0,870,4,866,870,447,423,813,42,511000
42,3,512000,1337143,2733,1328,1328,0,1328,1171,157,2733,2733,0,0,2733,2704,2378,309,0,4,1,12,29,27,2,0,0,0,2733,25,2708,2733,1320,1413,2378,42,512000
42,3,512800,2166168,1890,1094,1094,0,1094,775,319,1890,1890,0,0,1890,1840,859,952,5,15,1,8,50,47,2,1,0,0,1890,31,1859,1890,887,1003,859,42,512800
42,3,512900,491813,1787,828,828,0,828,685,143,1787,1787,0,0,1787,1746,718,1002,6,1,1,18,41,37,4,0,0,0,1787,24,1763,1787,817,970,718,42,512900
42,3,513800,1461660,2912,1624,1624,0,1624,1161,463,2912,2912,0,0,2912,2845,877,1937,4,7,0,20,67,53,13,1,0,0,2912,44,2868,2912,1332,1580,877,42,513800
42,3,514000,1131391,2315,1126,1126,0,1126,1002,124,2315,2315,0,0,2315,2269,648,1605,3,4,0,9,46,30,16,0,0,0,2315,8,2307,2315,938,1377,648,42,514000
42,3,515100,1114370,3104,1586,1586,0,1586,1413,173,3104,3104,0,0,3104,3065,1962,1067,6,14,0,16,39,37,2,0,0,0,3104,16,3088,3104,1452,1652,1962,42,515100
42,3,515200,554783,2245,1246,1246,0,1246,1178,68,2245,2245,0,0,2245,2208,1793,365,0,37,0,13,37,29,8,0,0,0,2245,14,2231,2245,1045,1200,1793,42,515200
42,3,515300,837325,2026,1103,1103,0,1103,1001,102,2026,2026,0,0,2026,1979,1426,520,4,9,2,18,47,37,8,2,0,0,2026,35,1991,2026,870,1156,1426,42,515300
42,3,515400,387804,1645,844,844,0,844,782,62,1645,1645,0,0,1645,1611,1400,172,1,23,4,11,34,29,5,0,0,0,1645,28,1617,1645,748,897,1400,42,515400
42,3,515500,210678,633,318,318,0,318,305,13,633,633,0,0,633,624,606,13,0,5,0,0,9,9,0,0,0,0,633,9,624,633,304,329,606,42,515500
42,3,516100,713389,1545,803,803,0,803,776,27,1545,1545,0,0,1545,1532,1432,66,0,22,1,11,13,13,0,0,0,0,1545,24,1521,1545,724,821,1432,42,516100
42,3,516200,817899,1766,927,927,0,927,863,64,1766,1766,0,0,1766,1752,1519,194,4,27,2,6,14,11,0,3,0,0,1766,21,1745,1766,805,961,1519,42,516200
42,3,517000,2511563,1998,1077,1077,0,1077,1020,57,1998,1998,0,0,1998,1963,1586,359,6,9,0,3,35,34,0,1,0,0,1998,11,1987,1998,890,1108,1586,42,517000
42,3,518001,2528863,3558,1566,1566,0,1566,1492,74,3558,3558,0,0,3558,3536,3395,89,0,49,1,2,22,21,0,1,0,0,3558,29,3529,3558,1661,1897,3395,42,518001
42,3,518002,1509220,3273,1637,1637,0,1637,1558,79,3273,3273,0,0,3273,3246,3076,115,2,42,0,11,27,26,1,0,0,0,3273,20,3253,3273,1518,1755,3076,42,518002
42,3,519000,5686107,3566,1567,1567,0,1567,1519,48,3566,3566,0,0,3566,3541,3156,300,5,69,1,10,25,18,5,2,0,0,3566,41,3525,3566,1719,1847,3156,42,519000
42,3,520001,4048621,3402,1689,1689,0,1689,1593,96,3402,3402,0,0,3402,3368,3126,166,0,68,2,6,34,30,1,3,0,0,3402,16,3386,3402,1620,1782,3126,42,520001
42,3,520002,2743593,3515,1743,1743,0,1743,1642,101,3515,3515,0,0,3515,3481,3292,137,6,37,2,7,34,32,2,0,0,0,3515,15,3500,3515,1646,1869,3292,42,520002
42,3,521100,4702318,4768,1813,1813,0,1813,1765,48,4768,4768,0,0,4768,4673,3652,883,16,92,6,24,95,82,13,0,0,0,4768,49,4719,4768,2301,2467,3652,42,521100
42,3,521200,7285883,4498,2390,2390,0,2390,2167,223,4498,4498,0,0,4498,4440,3788,393,2,238,0,19,58,54,4,0,0,0,4498,42,4456,4498,2120,2378,3788,42,521200
42,3,521301,7727926,4118,2019,2019,0,2019,1864,155,4118,4118,0,0,4118,4048,3527,281,6,217,3,14,70,62,8,0,0,0,4118,40,4078,4118,1749,2369,3527,42,521301
42,3,521302,7972078,4291,2219,2219,0,2219,2005,214,4291,4291,0,0,4291,4258,3608,426,6,195,4,19,33,29,4,0,0,0,4291,44,4247,4291,1989,2302,3608,42,521302
42,3,521401,7241083,2826,1201,1201,0,1201,1140,61,2826,2826,0,0,2826,2805,2607,118,3,74,0,3,21,20,1,0,0,0,2826,19,2807,2826,1365,1461,2607,42,521401
42,3,521402,5791121,4140,1538,1538,0,1538,1521,17,4140,4140,0,0,4140,4090,3565,186,0,333,0,6,50,49,0,1,0,0,4140,11,4129,4140,2059,2081,3565,42,521402
42,3,521500,10535160,4708,1979,1979,0,1979,1914,65,4708,4708,0,0,4708,4673,4371,145,8,145,0,4,35,34,1,0,0,0,4708,20,4688,4708,2199,2509,4371,42,521500
42,3,522000,1386271,3689,1901,1901,0,1901,1675,226,3689,3689,0,0,3689,3656,3619,16,4,15,0,2,33,31,1,0,0,1,3689,20,3669,3689,1757,1932,3619,42,522000
42,3,523100,6738441,5067,2155,2155,0,2155,1980,175,5067,5067,0,0,5067,4971,654,4279,12,3,0,23,96,78,14,4,0,0,5067,33,5034,5067,2341,2726,654,42,523100
42,3,523200,3194444,4423,1903,1903,0,1903,1807,96,4423,4423,0,0,4423,4330,2340,1951,5,14,1,19,93,87,6,0,0,0,4423,33,4390,4423,2016,2407,2340,42,523200
42,3,523300,3535857,4592,1859,1859,0,1859,1793,66,4592,4592,0,0,4592,4556,3734,770,6,29,1,16,36,33,3,0,0,0,4592,29,4563,4592,2067,2525,3734,42,523300
42,3,523400,3229658,5229,2446,2446,0,2446,2367,79,5229,5229,0,0,5229,5165,4329,774,4,39,0,19,64,59,4,1,0,0,5229,36,5193,5229,2410,2819,4329,42,523400
42,3,523501,4561503,5160,2113,2113,0,2113,2044,69,5160,5160,0,0,5160,5078,3615,1382,8,49,0,24,82,69,13,0,0,0,5160,41,5119,5160,2442,2718,3615,42,523501
42,3,523502,4641129,1703,771,771,0,771,720,51,1703,1703,0,0,1703,1684,1465,202,0,9,0,8,19,17,2,0,0,0,1703,11,1692,1703,833,870,1465,42,523502
42,3,523600,5308959,5276,2304,2304,0,2304,2244,60,5276,5276,0,0,5276,5227,4408,740,3,49,3,24,49,49,0,0,0,0,5276,45,5231,5276,2491,2785,4408,42,523600
42,3,523701,6397399,4555,1850,1850,0,1850,1788,62,4555,4555,0,0,4555,4537,4142,371,5,14,0,5,18,15,3,0,0,0,4555,9,4546,4555,2203,2352,4142,42,523701
42,3,523702,6860789,5718,2610,2610,0,2610,2488,122,5718,5718,0,0,5718,5658,4892,704,12,36,0,14,60,55,4,1,0,0,5718,45,5673,5718,2768,2950,4892,42,523702
42,3,523800,4811325,5086,2344,2344,0,2344,2259,85,5086,5086,0,0,5086,5063,4864,174,7,13,0,5,23,19,4,0,0,0,5086,15,5071,5086,2416,2670,4864,42,523800
42,3,524000,1385239,3124,1480,1480,0,1480,1376,104,3124,3124,0,0,3124,3108,2992,96,4,11,0,5,16,15,1,0,0,0,3124,10,3114,3124,1491,1633,2992,42,524000
42,3,525100,1409827,2200,1040,1040,0,1040,992,48,2200,2200,0,0,2200,2191,2163,17,1,9,0,1,9,8,1,0,0,0,2200,19,2181,2200,997,1203,2163,42,525100
42,3,525200,1132719,2213,1232,1232,0,1232,1177,55,2213,2213,0,0,2213,2204,2158,25,0,19,0,2,9,6,0,1,2,0,2213,6,2207,2213,947,1266,2158,42,525200
42,3,525300,1669050,2498,997,997,0,997,949,48,2498,2498,0,0,2498,2482,2441,20,6,6,0,9,16,16,0,0,0,0,2498,18,2480,2498,1111,1387,2441,42,525300
42,3,526101,34337551,6367,2592,2592,0,2592,2472,120,6367,6367,0,0,6367,6339,6133,140,3,52,1,10,28,28,0,0,0,0,6367,25,6342,6367,3053,3314,6133,42,526101
42,3,526102,13796965,2082,815,815,0,815,779,36,2082,2082,0,0,2082,2080,2061,11,0,1,5,2,2,2,0,0,0,0,2082,14,2068,2082,1029,1053,2061,42,526102
42,3,526201,6175485,3668,1427,1427,0,1427,1389,38,3668,3668,0,0,3668,3660,3578,56,0,22,0,4,8,8,0,0,0,0,3668,19,3649,3668,1811,1857,3578,42,526201
42,3,526202,11421394,4955,1974,1974,0,1974,1904,70,4955,4955,0,0,4955,4923,4647,199,6,64,0,7,32,29,2,1,0,0,4955,34,4921,4955,2392,2563,4647,42,526202
42,3,526301,4400848,4323,1600,1600,0,1600,1568,32,4323,4323,0,0,4323,4305,4202,71,5,21,0,6,18,18,0,0,0,0,4323,13,4310,4323,2095,2228,4202,42,526301
42,3,526302,4014529,5545,2216,2216,0,2216,2158,58,5545,5545,0,0,5545,5496,5133,266,9,71,1,16,49,48,1,0,0,0,5545,62,5483,5545,2771,2774,5133,42,526302
42,3,550900,997096,2630,1198,1198,0,1198,950,248,2630,2630,0,0,2630,2550,1579,934,13,6,0,18,80,73,7,0,0,0,2630,54,2576,2630,1253,1377,1579,42,550900
42,3,551200,1322262,4399,2027,2027,0,2027,1866,161,4399,4399,0,0,4399,4273,2874,1342,16,3,0,38,126,121,4,1,0,0,4399,68,4331,4399,1957,2442,2874,42,551200
42,3,551300,3895496,2783,1213,1213,0,1213,1155,58,2783,2783,0,0,2783,2769,2718,40,5,2,0,4,14,14,0,0,0,0,2783,16,2767,2783,1270,1513,2718,42,551300
42,3,551900,1774372,1789,946,946,0,946,811,135,1789,1789,0,0,1789,1745,1293,435,8,3,0,6,44,44,0,0,0,0,1789,32,1757,1789,860,929,1293,42,551900
42,3,552000,633779,3051,1349,1349,0,1349,1201,148,3051,3051,0,0,3051,2997,2488,476,8,1,0,24,54,51,3,0,0,0,3051,33,3018,3051,1409,1642,2488,42,552000
42,3,552100,672937,1589,639,639,0,639,472,167,1589,1589,0,0,1589,1553,609,931,0,4,0,9,36,36,0,0,0,0,1589,19,1570,1589,612,977,609,42,552100
42,3,552200,780707,1435,693,693,0,693,593,100,1435,1435,0,0,1435,1417,1382,27,1,1,0,6,18,17,1,0,0,0,1435,25,1410,1435,686,749,1382,42,552200
42,3,552300,845706,3077,1453,1453,0,1453,1151,302,3077,3077,0,0,3077,2950,1382,1524,12,6,2,24,127,112,15,0,0,0,3077,83,2994,3077,1429,1648,1382,42,552300
42,3,552400,2039596,3292,1608,1608,0,1608,1458,150,3292,3292,0,0,3292,3277,3086,172,3,4,0,12,15,14,1,0,0,0,3292,31,3261,3292,1562,1730,3086,42,552400
42,3,560400,528851,1770,1051,1051,0,1051,857,194,1770,1770,0,0,1770,1722,473,1216,8,14,2,9,48,35,12,1,0,0,1770,23,1747,1770,764,1006,473,42,560400
42,3,560500,468805,2286,1372,1372,0,1372,1261,111,2286,2286,0,0,2286,2227,1680,500,8,26,0,13,59,54,5,0,0,0,2286,32,2254,2286,1026,1260,1680,42,560500
42,3,560600,377309,1636,1076,1076,0,1076,749,327,1636,1636,0,0,1636,1597,361,1199,13,17,0,7,39,35,4,0,0,0,1636,13,1623,1636,749,887,361,42,560600
42,3,561000,552064,1916,1012,1012,0,1012,801,211,1916,1916,0,0,1916,1868,419,1424,14,2,1,8,48,43,5,0,0,0,1916,19,1897,1916,800,1116,419,42,561000
42,3,561100,483100,1414,691,691,0,691,569,122,1414,1414,0,0,1414,1379,71,1293,5,5,0,5,35,32,3,0,0,0,1414,19,1395,1414,617,797,71,42,561100
42,3,561200,401256,1744,1000,1000,0,1000,762,238,1744,1744,0,0,1744,1680,133,1526,6,3,3,9,64,47,16,0,1,0,1744,24,1720,1744,785,959,133,42,561200
42,3,561400,1852825,4775,2644,2644,0,2644,2493,151,4775,4775,0,0,4775,4669,1366,3230,6,32,1,34,106,90,16,0,0,0,4775,43,4732,4775,2053,2722,1366,42,561400
42,3,561500,1300623,3655,1850,1850,0,1850,1646,204,3655,3655,0,0,3655,3586,1112,2380,12,57,5,20,69,58,10,0,1,0,3655,43,3612,3655,1645,2010,1112,42,561500
42,5,980100,265408720,4902,2101,2101,0,2101,1869,232,4902,4902,0,0,4902,4880,4867,9,2,0,1,1,22,22,0,0,0,0,4902,6,4896,4902,2395,2507,4867,42,980100
42,5,980200,148212089,2471,1545,1545,0,1545,953,592,2471,2471,0,0,2471,2463,2453,5,1,0,3,1,8,8,0,0,0,0,2471,10,2461,2471,1255,1216,2453,42,980200
42,5,980300,150090908,3792,1868,1868,0,1868,1416,452,3792,3792,0,0,3792,3783,3732,48,1,2,0,0,9,8,1,0,0,0,3792,9,3783,3792,1903,1889,3732,42,980300
42,5,980400,69531091,2713,1123,1123,0,1123,1055,68,2713,2713,0,0,2713,2706,2692,2,0,4,0,8,7,7,0,0,0,0,2713,17,2696,2713,1317,1396,2692,42,980400
42,5,980500,81073915,5455,2388,2388,0,2388,2233,155,5455,5455,0,0,5455,5429,5398,4,8,15,1,3,26,26,0,0,0,0,5455,25,5430,5455,2590,2865,5398,42,980500
42,5,980600,131363532,3471,1521,1521,0,1521,1304,217,3471,3471,0,0,3471,3461,3429,7,11,3,0,11,10,10,0,0,0,0,3471,17,3454,3471,1713,1758,3429,42,980600
42,5,980700,129063945,4040,1667,1667,0,1667,1545,122,4040,4040,0,0,4040,4026,4006,8,4,4,0,4,14,14,0,0,0,0,4040,15,4025,4040,2001,2039,4006,42,980700
42,5,980800,174339248,4398,1917,1917,0,1917,1671,246,4398,4398,0,0,4398,4385,4375,6,2,2,0,0,13,12,1,0,0,0,4398,19,4379,4398,2204,2194,4375,42,980800
42,5,980900,43456546,5044,2254,2254,0,2254,2113,141,5044,5044,0,0,5044,5016,4974,27,5,5,1,4,28,25,3,0,0,0,5044,21,5023,5044,2439,2605,4974,42,980900
42,5,981000,1837285,3451,1713,1713,0,1713,1580,133,3451,3451,0,0,3451,3407,3257,134,5,6,0,5,44,43,1,0,0,0,3451,26,3425,3451,1580,1871,3257,42,981000
42,5,981100,2686405,4787,2251,2251,0,2251,2032,219,4787,4787,0,0,4787,4760,4658,75,11,12,0,4,27,26,1,0,0,0,4787,32,4755,4787,2164,2623,4658,42,981100
42,5,981200,136538429,6117,2432,2432,0,2432,2339,93,6117,6117,0,0,6117,6095,6078,9,0,7,1,0,22,22,0,0,0,0,6117,18,6099,6117,3096,3021,6078,42,981200
42,5,981300,42682204,2587,1114,1114,0,1114,1034,80,2587,2587,0,0,2587,2571,2535,26,1,5,3,1,16,14,2,0,0,0,2587,5,2582,2587,1301,1286,2535,42,981300
42,5,981400,36499076,2754,1186,1186,0,1186,1108,78,2754,2754,0,0,2754,2737,2622,89,1,0,0,25,17,17,0,0,0,0,2754,17,2737,2754,1360,1394,2622,42,981400
42,5,981500,2206940,3191,1482,1482,0,1482,1345,137,3191,3191,0,0,3191,3166,3072,80,4,4,2,4,25,24,1,0,0,0,3191,16,3175,3191,1509,1682,3072,42,981500
42,5,981600,105527775,4950,2074,2074,0,2074,1931,143,4950,4950,0,0,4950,4920,4865,24,6,11,0,14,30,30,0,0,0,0,4950,25,4925,4950,2434,2516,4865,42,981600
42,5,981700,168997492,3921,1614,1614,0,1614,1490,124,3921,3921,0,0,3921,3912,3902,4,3,0,0,3,9,8,1,0,0,0,3921,5,3916,3921,1949,1972,3902,42,981700
42,5,981800,1161398,2386,1193,1193,0,1193,1109,84,2386,2386,0,0,2386,2363,2327,30,1,4,0,1,23,21,2,0,0,0,2386,16,2370,2386,1087,1299,2327,42,981800
42,5,981900,2992884,1962,944,944,0,944,878,66,1962,1962,0,0,1962,1950,1931,5,0,5,1,8,12,11,1,0,0,0,1962,9,1953,1962,907,1055,1931,42,981900
42,7,600101,45629712,4307,1715,1715,0,1715,1600,115,4307,4307,0,0,4307,4296,4277,5,5,6,0,3,11,11,0,0,0,0,4307,24,4283,4307,2134,2173,4277,42,600101
42,7,600102,26593465,940,388,388,0,388,361,27,940,940,0,0,940,930,923,6,0,0,1,0,10,9,1,0,0,0,940,7,933,940,467,473,923,42,600102
42,7,600200,53792124,6120,2326,2326,0,2326,2238,88,6120,6120,0,0,6120,6082,6010,55,1,12,1,3,38,36,0,0,2,0,6120,20,6100,6120,2969,3151,6010,42,600200
42,7,600300,830134,732,327,327,0,327,307,20,732,732,0,0,732,730,726,0,0,0,0,4,2,2,0,0,0,0,732,8,724,732,365,367,726,42,600300
42,7,600400,1369401,856,409,409,0,409,373,36,856,856,0,0,856,845,841,4,0,0,0,0,11,5,6,0,0,0,856,3,853,856,407,449,841,42,600400
42,7,600500,47317836,2757,1156,1156,0,1156,1102,54,2757,2757,0,0,2757,2736,2685,27,15,5,0,4,21,21,0,0,0,0,2757,21,2736,2757,1334,1423,2685,42,600500
42,7,600601,57324314,2273,977,977,0,977,904,73,2273,2273,0,0,2273,2266,2256,2,4,2,0,2,7,7,0,0,0,0,2273,5,2268,2273,1111,1162,2256,42,600601
42,7,600602,77700362,2974,1139,1139,0,1139,1090,49,2974,2974,0,0,2974,2964,2915,37,3,6,0,3,10,10,0,0,0,0,2974,11,2963,2974,1430,1544,2915,42,600602
42,7,600700,41139580,7021,2933,2933,0,2933,2807,126,7021,7021,0,0,7021,6973,6853,65,1,43,2,9,48,47,1,0,0,0,7021,19,7002,7021,3434,3587,6853,42,600700
42,7,600800,2029492,1187,499,499,0,499,469,30,1187,1187,0,0,1187,1184,1153,24,1,1,0,5,3,3,0,0,0,0,1187,5,1182,1187,553,634,1153,42,600800
42,7,600900,1877593,1434,667,667,0,667,628,39,1434,1434,0,0,1434,1415,1252,143,5,6,3,6,19,16,3,0,0,0,1434,12,1422,1434,656,778,1252,42,600900
42,7,601000,4980166,3867,1600,1600,0,1600,1517,83,3867,3867,0,0,3867,3828,3761,49,5,5,0,8,39,38,1,0,0,0,3867,30,3837,3867,1816,2051,3761,42,601000
42,7,601100,1914838,3562,1214,1214,0,1214,1133,81,3562,3562,0,0,3562,3488,3119,290,6,50,0,23,74,73,1,0,0,0,3562,40,3522,3562,1663,1899,3119,42,601100
42,7,601200,2469069,3351,1808,1808,0,1808,1492,316,3351,3351,0,0,3351,3259,2392,844,6,9,2,6,92,83,9,0,0,0,3351,21,3330,3351,1521,1830,2392,42,601200
42,7,601300,1104061,3007,1358,1358,0,1358,1173,185,3007,3007,0,0,3007,2938,2308,605,1,3,0,21,69,63,5,1,0,0,3007,44,2963,3007,1354,1653,2308,42,601300
42,7,601400,1450186,3754,1651,1651,0,1651,1500,151,3754,3754,0,0,3754,3681,3327,331,9,11,0,3,73,64,9,0,0,0,3754,16,3738,3754,1809,1945,3327,42,601400
42,7,601500,2387948,3194,1484,1484,0,1484,1366,118,3194,3194,0,0,3194,3102,2690,387,7,2,0,16,92,86,6,0,0,0,3194,17,3177,3194,1454,1740,2690,42,601500
42,7,601600,2133653,1674,764,764,0,764,726,38,1674,1674,0,0,1674,1659,1597,53,4,3,0,2,15,14,1,0,0,0,1674,9,1665,1674,787,887,1597,42,601600
42,7,601700,26059676,3734,1450,1450,0,1450,1394,56,3734,3734,0,0,3734,3710,3625,68,6,5,2,4,24,24,0,0,0,0,3734,8,3726,3734,1836,1898,3625,42,601700
42,7,601800,84612394,7076,2879,2879,0,2879,2736,143,7076,7076,0,0,7076,7037,7004,12,9,11,0,1,39,36,2,0,1,0,7076,24,7052,7076,3542,3534,7004,42,601800
42,7,601900,9884383,3129,1268,1268,0,1268,1213,55,3129,3129,0,0,3129,3097,2977,114,3,3,0,0,32,31,1,0,0,0,3129,6,3123,3129,1541,1588,2977,42,601900
42,7,602000,1028830,623,293,293,0,293,283,10,623,623,0,0,623,619,597,22,0,0,0,0,4,4,0,0,0,0,623,1,622,623,293,330,597,42,602000
42,7,602100,1515150,4014,1900,1900,0,1900,1732,168,4014,4014,0,0,4014,3941,3364,537,9,8,0,23,73,70,3,0,0,0,4014,37,3977,4014,1850,2164,3364,42,602100
42,7,602200,1791310,739,361,361,0,361,335,26,739,739,0,0,739,729,658,65,1,3,0,2,10,10,0,0,0,0,739,4,735,739,350,389,658,42,602200
42,7,602300,1237070,2621,1356,1356,0,1356,1232,124,2621,2621,0,0,2621,2611,2548,35,6,13,0,9,10,10,0,0,0,0,2621,21,2600,2621,1188,1433,2548,42,602300
42,7,602400,1178735,2154,941,941,0,941,880,61,2154,2154,0,0,2154,2152,2057,91,0,0,0,4,2,2,0,0,0,0,2154,21,2133,2154,1092,1062,2057,42,602400
42,7,602500,2422702,1451,827,827,0,827,775,52,1451,1451,0,0,1451,1445,1423,20,0,2,0,0,6,6,0,0,0,0,1451,7,1444,1451,622,829,1423,42,602500
42,7,602601,35294406,4194,1599,1599,0,1599,1549,50,4194,4194,0,0,4194,4172,4142,8,3,16,0,3,22,21,1,0,0,0,4194,24,4170,4194,2073,2121,4142,42,602601
42,7,602602,13945867,3830,1276,1276,0,1276,1234,42,3830,3830,0,0,3830,3819,3718,78,1,19,1,2,11,11,0,0,0,0,3830,25,3805,3830,1683,2147,3718,42,602602
42,7,602701,25489716,1921,816,816,0,816,772,44,1921,1921,0,0,1921,1913,1861,37,1,3,0,11,8,8,0,0,0,0,1921,27,1894,1921,954,967,1861,42,602701
42,7,602702,60715196,3822,1467,1467,0,1467,1398,69,3822,3822,0,0,3822,3802,3714,75,1,3,0,9,20,19,1,0,0,0,3822,30,3792,3822,1886,1936,3714,42,602702
42,7,602800,5285636,3137,1651,1651,0,1651,1424,227,3137,3137,0,0,3137,3071,2375,654,14,0,0,28,66,63,3,0,0,0,3137,116,3021,3137,1419,1718,2375,42,602800
42,7,602900,73758306,3276,1239,1239,0,1239,1169,70,3276,3276,0,0,3276,3241,3219,7,8,3,1,3,35,35,0,0,0,0,3276,22,3254,3276,1662,1614,3219,42,602900
42,7,603000,47998462,3397,1227,1227,0,1227,1186,41,3397,3397,0,0,3397,3375,3353,13,5,1,0,3,22,21,1,0,0,0,3397,24,3373,3397,1698,1699,3353,42,603000
42,7,603100,15873963,580,222,222,0,222,210,12,580,580,0,0,580,577,575,0,2,0,0,0,3,3,0,0,0,0,580,0,580,580,298,282,575,42,603100
42,7,603201,11069355,5079,2036,2036,0,2036,1947,89,5079,5079,0,0,5079,5056,4850,160,8,31,0,7,23,20,3,0,0,0,5079,40,5039,5079,2503,2576,4850,42,603201
42,7,603202,28804856,6413,2402,2402,0,2402,2323,79,6413,6413,0,0,6413,6372,6167,181,2,15,0,7,41,37,4,0,0,0,6413,40,6373,6413,3213,3200,6167,42,603202
42,7,603300,3584781,4141,1789,1789,0,1789,1731,58,4141,4141,0,0,4141,4115,4010,95,0,8,0,2,26,26,0,0,0,0,4141,27,4114,4141,1915,2226,4010,42,603300
42,7,603400,1834857,2145,1103,1103,0,1103,978,125,2145,2145,0,0,2145,2129,2095,27,0,6,0,1,16,16,0,0,0,0,2145,11,2134,2145,1014,1131,2095,42,603400
42,7,603500,1530006,1763,731,731,0,731,687,44,1763,1763,0,0,1763,1736,1636,91,1,4,0,4,27,26,1,0,0,0,1763,13,1750,1763,853,910,1636,42,603500
42,7,603600,3249387,2290,1026,1026,0,1026,988,38,2290,2290,0,0,2290,2281,2250,29,1,0,0,1,9,9,0,0,0,0,2290,11,2279,2290,1081,1209,2250,42,603600
42,7,603700,5923357,4377,1986,1986,0,1986,1900,86,4377,4377,0,0,4377,4359,4315,32,2,6,0,4,18,17,1,0,0,0,4377,25,4352,4377,1995,2382,4315,42,603700
42,7,603801,10455972,3052,1079,1079,0,1079,1056,23,3052,3052,0,0,3052,3040,2973,44,2,14,0,7,12,12,0,0,0,0,3052,12,3040,3052,1542,1510,2973,42,603801
42,7,603802,10036410,2859,1061,1061,0,1061,1042,19,2859,2859,0,0,2859,2844,2815,12,6,8,0,3,15,15,0,0,0,0,2859,17,2842,2859,1405,1454,2815,42,603802
42,7,603803,25347486,3452,1489,1489,0,1489,1430,59,3452,3452,0,0,3452,3432,3419,6,1,4,0,2,20,20,0,0,0,0,3452,12,3440,3452,1726,1726,3419,42,603803
42,7,603900,7426777,3373,1509,1509,0,1509,1439,70,3373,3373,0,0,3373,3352,3288,49,0,4,4,7,21,19,2,0,0,0,3373,19,3354,3373,1605,1768,3288,42,603900
42,7,604000,1251790,2832,1361,1361,0,1361,1254,107,2832,2832,0,0,2832,2784,2439,313,3,10,0,19,48,43,5,0,0,0,2832,53,2779,2832,1308,1524,2439,42,604000
42,7,604100,1390978,3156,1748,1748,0,1748,1461,287,3156,3156,0,0,3156,3101,2590,470,1,17,0,23,55,52,3,0,0,0,3156,57,3099,3156,1502,1654,2590,42,604100
42,7,604200,1202524,1781,990,990,0,990,880,110,1781,1781,0,0,1781,1755,1628,101,2,8,1,15,26,18,4,1,3,0,1781,32,1749,1781,861,920,1628,42,604200
42,7,604300,4482819,2631,1211,1211,0,1211,1029,182,2631,2631,0,0,2631,2603,1796,795,2,5,2,3,28,28,0,0,0,0,2631,33,2598,2631,1253,1378,1796,42,604300
42,7,604400,698328,605,322,322,0,322,284,38,605,605,0,0,605,594,592,0,1,0,0,1,11,11,0,0,0,0,605,6,599,605,298,307,592,42,604400
42,7,604500,2138713,3456,1787,1787,0,1787,1449,338,3456,3456,0,0,3456,3382,526,2843,3,2,2,6,74,58,16,0,0,0,3456,30,3426,3456,1481,1975,526,42,604500
42,7,604600,2568754,3476,1721,1721,0,1721,1616,105,3476,3476,0,0,3476,3434,2999,420,2,7,0,6,42,42,0,0,0,0,3476,37,3439,3476,1552,1924,2999,42,604600
42,7,604700,709176,1566,802,802,0,802,746,56,1566,1566,0,0,1566,1553,1431,110,0,7,0,5,13,13,0,0,0,0,1566,11,1555,1566,728,838,1431,42,604700
42,7,604800,10342696,4723,2033,2033,0,2033,1973,60,4723,4723,0,0,4723,4704,4611,88,0,4,0,1,19,19,0,0,0,0,4723,17,4706,4723,2212,2511,4611,42,604800
42,7,604901,25361260,3974,1676,1676,0,1676,1592,84,3974,3974,0,0,3974,3956,3839,98,1,11,2,5,18,17,1,0,0,0,3974,29,3945,3974,1890,2084,3839,42,604901
42,7,604902,9002717,5099,2183,2183,0,2183,2120,63,5099,5099,0,0,5099,5073,4986,58,0,28,0,1,26,26,0,0,0,0,5099,21,5078,5099,2419,2680,4986,42,604902
42,7,605001,59229704,2802,1069,1069,0,1069,1007,62,2802,2802,0,0,2802,2754,2741,5,3,0,0,5,48,48,0,0,0,0,2802,17,2785,2802,1420,1382,2741,42,605001
42,7,605002,116828351,3659,1464,1464,0,1464,1336,128,3659,3659,0,0,3659,3639,3599,21,7,5,0,7,20,15,5,0,0,0,3659,36,3623,3659,1833,1826,3599,42,605002
42,9,980100,130804848,3747,1613,1613,0,1613,1446,167,3747,3747,0,0,3747,3725,3685,5,4,16,0,15,22,20,2,0,0,0,3747,26,3721,3747,1769,1978,3685,42,980100
42,9,980200,191933873,3578,1734,1734,0,1734,1360,374,3578,3578,0,0,3578,3565,3554,4,5,1,0,1,13,13,0,0,0,0,3578,12,3566,3578,1790,1788,3554,42,980200
42,9,980300,165531285,5067,2212,2212,0,2212,1911,301,5067,5067,0,0,5067,5038,4976,21,3,24,0,14,29,29,0,0,0,0,5067,32,5035,5067,2537,2530,4976,42,980300
42,9,980400,227586879,5089,2095,2095,0,2095,1890,205,5089,5089,0,0,5089,5066,5053,4,3,3,0,3,23,23,0,0,0,0,5089,23,5066,5089,2523,2566,5053,42,980400
42,9,980500,255644581,3831,1837,1837,0,1837,1507,330,3831,3831,0,0,3831,3814,3795,7,5,7,0,0,17,17,0,0,0,0,3831,20,3811,3831,1934,1897,3795,42,980500
42,9,980600,102444969,5228,2557,2557,0,2557,2215,342,5228,5228,0,0,5228,5204,5165,20,1,8,2,8,24,19,1,0,4,0,5228,23,5205,5228,2502,2726,5165,42,980600
42,9,980700,2873788,3141,1640,1640,0,1640,1536,104,3141,3141,0,0,3141,3118,3069,16,2,24,3,4,23,22,1,0,0,0,3141,25,3116,3141,1403,1738,3069,42,980700
42,9,980800,177657419,5417,2403,2403,0,2403,2144,259,5417,5417,0,0,5417,5376,5262,72,3,26,0,13,41,40,1,0,0,0,5417,32,5385,5417,2693,2724,5262,42,980800
42,9,980900,372614323,4989,2697,2697,0,2697,1947,750,4989,4989,0,0,4989,4967,4928,14,4,12,2,7,22,22,0,0,0,0,4989,31,4958,4989,2516,2473,4928,42,980900
42,9,981000,703556416,5638,2784,2784,0,2784,2118,666,5638,5638,0,0,5638,5602,5557,13,11,14,0,7,36,36,0,0,0,0,5638,21,5617,5638,2824,2814,5557,42,981000
42,9,981100,296922032,4259,1957,1957,0,1957,1694,263,4259,4259,0,0,4259,4238,4209,2,13,8,0,6,21,21,0,0,0,0,4259,18,4241,4259,2140,2119,4209,42,981100
42,11,100,804286,5110,2766,2766,0,2766,2330,436,5110,5110,0,0,5110,4883,2338,706,43,99,3,1694,227,218,6,3,0,0,5110,2644,2466,5110,2492,2618,2338,42,100
42,11,200,1906888,3612,1674,1674,0,1674,1621,53,3612,3612,0,0,3612,3446,1906,610,21,56,1,852,166,158,7,1,0,0,3612,1558,2054,3612,1552,2060,1906,42,200
42,11,300,1476622,1915,765,765,0,765,699,66,1915,1915,0,0,1915,1838,1273,274,3,79,0,209,77,68,9,0,0,0,1915,395,1520,1915,964,951,1273,42,300
42,11,400,1766533,3411,1407,1407,0,1407,1292,115,3411,3411,0,0,3411,3262,2356,334,15,56,2,499,149,144,4,0,1,0,3411,902,2509,3411,1651,1760,2356,42,400
42,11,500,1233899,3119,1279,1279,0,1279,1188,91,3119,3119,0,0,3119,3024,2413,195,1,35,0,380,95,90,5,0,0,0,3119,580,2539,3119,1494,1625,2413,42,500
42,11,600,1520303,3370,1121,1121,0,1121,1063,58,3370,3370,0,0,3370,3325,2928,202,9,107,3,76,45,43,2,0,0,0,3370,159,3211,3370,1570,1800,2928,42,600
42,11,700,613157,3602,1403,1403,0,1403,1294,109,3602,3602,0,0,3602,3481,2739,268,4,35,3,432,121,115,6,0,0,0,3602,678,2924,3602,1766,1836,2739,42,700
42,11,800,303924,3640,1444,1444,0,1444,1288,156,3640,3640,0,0,3640,3515,2462,279,12,93,2,667,125,102,23,0,0,0,3640,1188,2452,3640,1819,1821,2462,42,800
42,11,900,459096,2378,1184,1184,0,1184,1022,162,2378,2378,0,0,2378,2282,1483,392,11,28,2,366,96,89,7,0,0,0,2378,610,1768,2378,1193,1185,1483,42,900
42,11,1000,255330,2982,1129,1129,0,1129,948,181,2982,2982,0,0,2982,2790,1162,671,14,45,0,898,192,186,6,0,0,0,2982,1371,1611,2982,1445,1537,1162,42,1000
42,11,1100,778540,3834,1442,1442,0,1442,1177,265,3834,3834,0,0,3834,3645,1715,841,10,25,1,1053,189,181,5,0,1,2,3834,1881,1953,3834,1863,1971,1715,42,1100
42,11,1200,156708,1900,645,645,0,645,522,123,1900,1900,0,0,1900,1807,510,581,33,7,0,676,93,92,1,0,0,0,1900,1119,781,1900,967,933,510,42,1200
42,11,1300,577502,3011,1340,1340,0,1340,1094,246,3011,3011,0,0,3011,2856,1209,664,19,14,1,949,155,148,7,0,0,0,3011,1751,1260,3011,1496,1515,1209,42,1300
42,11,1400,374313,4060,1647,1647,0,1647,1367,280,4060,4060,0,0,4060,3886,1981,402,14,57,1,1431,174,161,13,0,0,0,4060,2176,1884,4060,2038,2022,1981,42,1400
42,11,1500,232939,3080,1141,1141,0,1141,1023,118,3080,3080,0,0,3080,2940,1965,286,7,34,5,643,140,135,5,0,0,0,3080,1080,2000,3080,1509,1571,1965,42,1500
42,11,1600,247937,2358,939,939,0,939,840,99,2358,2358,0,0,2358,2257,1575,182,19,41,0,440,101,99,2,0,0,0,2358,752,1606,2358,1137,1221,1575,42,1600
42,11,1700,366894,2954,1249,1249,0,1249,956,293,2954,2954,0,0,2954,2795,1406,256,25,77,0,1031,159,141,7,0,11,0,2954,1728,1226,2954,1491,1463,1406,42,1700
42,11,1800,3120291,2597,1244,1244,0,1244,1137,107,2597,2597,0,0,2597,2528,2115,176,6,32,0,199,69,63,6,0,0,0,2597,361,2236,2597,1241,1356,2115,42,1800
42,11,1900,175023,2399,1301,1301,0,1301,1073,228,2399,2399,0,0,2399,2282,1345,251,8,72,0,606,117,102,15,0,0,0,2399,1031,1368,2399,1151,1248,1345,42,1900
42,11,2000,777152,3784,1717,1717,0,1717,1536,181,3784,3784,0,0,3784,3661,3008,275,9,32,0,337,123,120,3,0,0,0,3784,655,3129,3784,1824,1960,3008,42,2000
42,11,2100,479143,2745,1136,1136,0,1136,962,174,2745,2745,0,0,2745,2628,1743,298,8,18,1,560,117,114,3,0,0,0,2745,911,1834,2745,1320,1425,1743,42,2100
42,11,2200,536843,2066,807,807,0,807,671,136,2066,2066,0,0,2066,1904,875,238,8,21,3,759,162,156,6,0,0,0,2066,1239,827,2066,1071,995,875,42,2200
42,11,2300,276053,2118,916,916,0,916,738,178,2118,2118,0,0,2118,2014,948,276,6,20,0,764,104,103,1,0,0,0,2118,1181,937,2118,1098,1020,948,42,2300
42,11,2500,1180928,3599,1584,1584,0,1584,1400,184,3599,3599,0,0,3599,3455,1460,744,20,92,2,1137,144,141,3,0,0,0,3599,2057,1542,3599,1688,1911,1460,42,2500
42,11,2600,1498892,3183,1129,1129,0,1129,1069,60,3183,3183,0,0,3183,3016,1291,321,20,47,0,1337,167,161,6,0,0,0,3183,1978,1205,3183,1389,1794,1291,42,2600
42,11,2700,1492961,1928,937,937,0,937,889,48,1928,1928,0,0,1928,1884,1680,113,2,41,0,48,44,44,0,0,0,0,1928,144,1784,1928,866,1062,1680,42,2700
42,11,2900,2885515,2453,969,969,0,969,915,54,2453,2453,0,0,2453,2412,2174,112,9,33,2,82,41,41,0,0,0,0,2453,173,2280,2453,1110,1343,2174,42,2900
42,11,10100,169022220,6000,2284,2284,0,2284,2143,141,6000,6000,0,0,6000,5965,5854,32,6,36,1,36,35,33,2,0,0,0,6000,92,5908,6000,3073,2927,5854,42,10100
42,11,10200,152268758,8990,3505,3505,0,3505,3290,215,8990,8990,0,0,8990,8931,8792,41,8,28,0,62,59,57,2,0,0,0,8990,127,8863,8990,4554,4436,8792,42,10200
42,11,10301,51473294,8563,2682,2682,0,2682,2598,84,8563,8563,0,0,8563,8494,8028,321,9,99,0,37,69,69,0,0,0,0,8563,585,7978,8563,4610,3953,8028,42,10301
42,11,10302,49180588,2858,1116,1116,0,1116,1065,51,2858,2858,0,0,2858,2839,2789,20,2,10,0,18,19,19,0,0,0,0,2858,53,2805,2858,1427,1431,2789,42,10302
42,11,10400,176530529,7792,2693,2693,0,2693,2585,108,7792,7792,0,0,7792,7731,7470,144,9,19,0,89,61,57,4,0,0,0,7792,185,7607,7792,4108,3684,7470,42,10400
42,11,10500,41674427,6271,2583,2583,0,2583,2478,105,6271,6271,0,0,6271,6234,6023,80,0,59,0,72,37,35,2,0,0,0,6271,126,6145,6271,3081,3190,6023,42,10500
42,11,10600,40770895,6300,2448,2448,0,2448,2387,61,6300,6300,0,0,6300,6271,6140,54,6,54,0,17,29,26,3,0,0,0,6300,62,6238,6300,3043,3257,6140,42,10600
42,11,10700,35637519,5491,2027,2027,0,2027,1947,80,5491,5491,0,0,5491,5459,5310,80,2,25,0,42,32,32,0,0,0,0,5491,86,5405,5491,2819,2672,5310,42,10700
42,11,10800,33385497,9119,3413,3413,0,3413,3305,108,9119,9119,0,0,9119,8994,8319,325,6,211,1,132,125,124,1,0,0,0,9119,363,8756,9119,4385,4734,8319,42,10800
42,11,10902,3486066,2639,1269,1269,0,1269,1233,36,2639,2639,0,0,2639,2612,2527,28,4,21,0,32,27,26,1,0,0,0,2639,72,2567,2639,1249,1390,2527,42,10902
42,11,10903,9146772,4901,2176,2176,0,2176,2107,69,4901,4901,0,0,4901,4876,4692,49,5,92,1,37,25,22,3,0,0,0,4901,106,4795,4901,2323,2578,4692,42,10903
42,11,10904,2033238,3506,1440,1440,0,1440,1415,25,3506,3506,0,0,3506,3472,3291,33,1,137,0,10,34,34,0,0,0,0,3506,55,3451,3506,1682,1824,3291,42,10904
42,11,10905,2633477,4281,1967,1967,0,1967,1913,54,4281,4281,0,0,4281,4225,4098,51,2,30,0,44,56,48,8,0,0,0,4281,108,4173,4281,2065,2216,4098,42,10905
42,11,11000,2400909,4165,1741,1741,0,1741,1692,49,4165,4165,0,0,4165,4130,3931,48,4,115,0,32,35,34,1,0,0,0,4165,76,4089,4165,2003,2162,3931,42,11000
42,11,11100,9901992,8587,3539,3539,0,3539,3359,180,8587,8587,0,0,8587,8513,8137,129,6,163,2,76,74,69,5,0,0,0,8587,157,8430,8587,3917,4670,8137,42,11100
42,11,11200,1481281,4049,1783,1783,0,1783,1666,117,4049,4049,0,0,4049,3990,3617,163,9,62,1,138,59,58,1,0,0,0,4049,315,3734,4049,1831,2218,3617,42,11200
42,11,11300,1524373,2679,1254,1254,0,1254,1215,39,2679,2679,0,0,2679,2662,2568,22,1,43,0,28,17,16,1,0,0,0,2679,54,2625,2679,1296,1383,2568,42,11300
42,11,11400,2639355,5059,2321,2321,0,2321,2238,83,5059,5059,0,0,5059,5008,4913,25,5,27,0,38,51,48,3,0,0,0,5059,106,4953,5059,2394,2665,4913,42,11400
42,11,11500,2259785,2963,1259,1259,0,1259,1211,48,2963,2963,0,0,2963,2942,2868,33,2,13,0,26,21,21,0,0,0,0,2963,50,2913,2963,1402,1561,2868,42,11500
42,11,11601,5062750,5069,2212,2212,0,2212,2155,57,5069,5069,0,0,5069,4992,4557,151,1,149,3,131,77,73,2,2,0,0,5069,234,4835,5069,2319,2750,4557,42,11601
42,11,11602,23078618,3907,1623,1623,0,1623,1566,57,3907,3907,0,0,3907,3883,3743,48,4,56,2,30,24,21,3,0,0,0,3907,91,3816,3907,1910,1997,3743,42,11602
42,11,11603,25358176,4839,2291,2291,0,2291,2219,72,4839,4839,0,0,4839,4803,4664,66,3,55,1,14,36,35,1,0,0,0,4839,64,4775,4839,2400,2439,4664,42,11603
42,11,11701,87798160,6869,2568,2568,0,2568,2488,80,6869,6869,0,0,6869,6824,6724,22,14,17,2,45,45,44,1,0,0,0,6869,60,6809,6869,3469,3400,6724,42,11701
42,11,11702,46200913,4459,1611,1611,0,1611,1558,53,4459,4459,0,0,4459,4417,4363,27,6,10,0,11,42,37,5,0,0,0,4459,41,4418,4459,2266,2193,4363,42,11702
42,11,11703,37413034,2347,937,937,0,937,900,37,2347,2347,0,0,2347,2326,2290,9,0,22,0,5,21,21,0,0,0,0,2347,20,2327,2347,1165,1182,2290,42,11703
42,11,11800,3597094,5064,1927,1927,0,1927,1854,73,5064,5064,0,0,5064,5017,4905,53,6,18,3,32,47,45,2,0,0,0,5064,63,5001,5064,2517,2547,4905,42,11800
42,11,11901,47395572,8867,3323,3323,0,3323,3219,104,8867,8867,0,0,8867,8776,8484,181,17,59,1,34,91,88,3,0,0,0,8867,89,8778,8867,4380,4487,8484,42,11901
42,11,11902,60059372,3453,1370,1370,0,1370,1324,46,3453,3453,0,0,3453,3425,3385,20,5,4,1,10,28,28,0,0,0,0,3453,33,3420,3453,1729,1724,3385,42,11902
42,11,12001,8251961,2624,1093,1093,0,1093,1027,66,2624,2624,0,0,2624,2583,2441,121,2,8,3,8,41,41,0,0,0,0,2624,42,2582,2624,1298,1326,2441,42,12001
42,11,12002,10161520,7251,2860,2860,0,2860,2775,85,7251,7251,0,0,7251,7200,6933,151,6,91,0,19,51,48,3,0,0,0,7251,102,7149,7251,3537,3714,6933,42,12002
42,11,12101,2350278,1812,781,781,0,781,757,24,1812,1812,0,0,1812,1784,1730,39,0,14,0,1,28,25,3,0,0,0,1812,33,1779,1812,873,939,1730,42,12101
42,11,12102,18884410,9093,3422,3422,0,3422,3322,100,9093,9093,0,0,9093,9038,8671,145,9,127,0,86,55,55,0,0,0,0,9093,209,8884,9093,4436,4657,8671,42,12102
42,11,12103,25869551,2193,833,833,0,833,810,23,2193,2193,0,0,2193,2179,2136,16,5,19,0,3,14,13,1,0,0,0,2193,21,2172,2193,1080,1113,2136,42,12103
42,11,12200,2687522,3113,1373,1373,0,1373,1316,57,3113,3113,0,0,3113,3085,3001,32,1,32,0,19,28,23,2,3,0,0,3113,106,3007,3113,1490,1623,3001,42,12200
42,11,12300,10613007,4381,1918,1918,0,1918,1843,75,4381,4381,0,0,4381,4349,4232,31,0,40,0,46,32,32,0,0,0,0,4381,123,4258,4381,2135,2246,4232,42,12300
42,11,12400,14594014,5067,2198,2198,0,2198,2095,103,5067,5067,0,0,5067,5006,4826,53,4,19,0,104,61,55,6,0,0,0,5067,270,4797,5067,2326,2741,4826,42,12400
42,11,12500,3787540,1865,848,848,0,848,824,24,1865,1865,0,0,1865,1855,1819,10,0,12,0,14,10,10,0,0,0,0,1865,78,1787,1865,898,967,1819,42,12500
42,11,12600,2118270,2096,891,891,0,891,849,42,2096,2096,0,0,2096,2071,1947,45,1,20,0,58,25,22,3,0,0,0,2096,131,1965,2096,1040,1056,1947,42,12600
42,11,12700,10619503,7277,2960,2960,0,2960,2871,89,7277,7277,0,0,7277,7226,6976,90,1,64,0,95,51,49,2,0,0,0,7277,159,7118,7277,3523,3754,6976,42,12700
42,11,12800,2107902,3759,1685,1685,0,1685,1636,49,3759,3759,0,0,3759,3726,3605,28,2,14,1,76,33,30,3,0,0,0,3759,204,3555,3759,1777,1982,3605,42,12800
42,11,12900,94263250,7272,2928,2928,0,2928,2815,113,7272,7272,0,0,7272,7242,7166,21,6,29,3,17,30,29,1,0,0,0,7272,71,7201,7272,3646,3626,7166,42,12900
42,11,13000,68661949,6377,2441,2441,0,2441,2356,85,6377,6377,0,0,6377,6340,5960,332,5,21,2,20,37,34,2,1,0,0,6377,42,6335,6377,3261,3116,5960,42,13000
42,11,13100,21688737,5270,2030,2030,0,2030,1994,36,5270,5270,0,0,5270,5244,5201,10,4,18,7,4,26,26,0,0,0,0,5270,18,5252,5270,2583,2687,5201,42,13100
42,11,13200,2064980,3940,1885,1885,0,1885,1805,80,3940,3940,0,0,3940,3922,3894,8,1,14,0,5,18,18,0,0,0,0,3940,29,3911,3940,1893,2047,3894,42,13200
42,11,13300,79024524,8521,3313,3313,0,3313,3161,152,8521,8521,0,0,8521,8472,8372,37,8,29,0,26,49,47,2,0,0,0,8521,72,8449,8521,4334,4187,8372,42,13300
42,11,13401,80225994,7541,2789,2789,0,2789,2708,81,7541,7541,0,0,7541,7483,7429,15,3,21,0,15,58,56,2,0,0,0,7541,88,7453,7541,3804,3737,7429,42,13401
42,11,13402,66239395,3126,1175,1175,0,1175,1127,48,3126,3126,0,0,3126,3123,3103,9,4,5,0,2,3,3,0,0,0,0,3126,9,3117,3126,1592,1534,3103,42,13402
42,11,13500,56563864,7770,2912,2912,0,2912,2792,120,7770,7770,0,0,7770,7717,7502,59,7,89,0,60,53,53,0,0,0,0,7770,190,7580,7770,3903,3867,7502,42,13500
42,11,13600,2696195,4018,1623,1623,0,1623,1584,39,4018,4018,0,0,4018,3996,3930,11,0,16,0,39,22,22,0,0,0,0,4018,69,3949,4018,1946,2072,3930,42,13600
42,11,13700,109818226,8141,3139,3139,0,3139,2993,146,8141,8141,0,0,8141,8107,7895,77,10,25,2,98,34,31,3,0,0,0,8141,207,7934,8141,4120,4021,7895,42,13700
42,11,13800,4816585,4114,1932,1932,0,1932,1824,108,4114,4114,0,0,4114,4080,4028,14,5,13,0,20,34,30,4,0,0,0,4114,34,4080,4114,1935,2179,4028,42,13800
42,11,13900,243596420,7613,3037,3037,0,3037,2783,254,7613,7613,0,0,7613,7564,7493,29,9,15,0,18,49,48,1,0,0,0,7613,63,7550,7613,3878,3735,7493,42,13900
42,11,14000,4112111,5067,1940,1940,0,1940,1874,66,5067,5067,0,0,5067,5042,4915,50,5,45,0,27,25,23,2,0,0,0,5067,49,5018,5067,2420,2647,4915,42,14000
42,11,14100,68969706,6486,1600,1600,0,1600,1551,49,6486,6486,0,0,6486,6433,6238,124,5,37,8,21,53,50,3,0,0,0,6486,93,6393,6486,2932,3554,6238,42,14100
42,11,14200,60789564,7556,2939,2939,0,2939,2834,105,7556,7556,0,0,7556,7534,7475,19,9,18,0,13,22,21,1,0,0,0,7556,70,7486,7556,3674,3882,7475,42,14200
42,13,10101,187170042,4162,1719,1719,0,1719,1613,106,4162,4162,0,0,4162,4146,4132,6,1,7,0,0,16,15,1,0,0,0,4162,10,4152,4162,2039,2123,4132,42,10101
42,13,10102,2573137,2862,1403,1403,0,1403,1286,117,2862,2862,0,0,2862,2846,2820,14,3,3,0,6,16,15,1,0,0,0,2862,22,2840,2862,1255,1607,2820,42,10102
42,13,10103,2566107,2632,1152,1152,0,1152,1083,69,2632,2632,0,0,2632,2623,2611,4,3,3,0,2,9,9,0,0,0,0,2632,8,2624,2632,1251,1381,2611,42,10103
42,13,10401,1197085,2016,822,822,0,822,776,46,2016,2016,0,0,2016,2003,1992,2,1,4,0,4,13,9,4,0,0,0,2016,18,1998,2016,954,1062,1992,42,10401
42,13,10402,157395151,6328,2661,2661,0,2661,2530,131,6328,6328,0,0,6328,6299,6265,6,11,11,1,5,29,25,4,0,0,0,6328,18,6310,6328,3135,3193,6265,42,10402
42,13,10500,76263649,4046,1637,1637,0,1637,1579,58,4046,4046,0,0,4046,4021,3995,18,4,3,0,1,25,21,4,0,0,0,4046,12,4034,4046,1979,2067,3995,42,10500
42,13,10600,16207452,2524,1017,1017,0,1017,967,50,2524,2524,0,0,2524,2514,2473,20,1,20,0,0,10,10,0,0,0,0,2524,10,2514,2524,1238,1286,2473,42,10600
42,13,10700,66463192,6383,2762,2762,0,2762,2586,176,6383,6383,0,0,6383,6365,6291,32,3,29,2,8,18,17,1,0,0,0,6383,29,6354,6383,3092,3291,6291,42,10700
42,13,10800,165405536,3740,1508,1508,0,1508,1426,82,3740,3740,0,0,3740,3718,3676,32,4,5,0,1,22,22,0,0,0,0,3740,14,3726,3740,1849,1891,3676,42,10800
42,13,10900,126063150,7694,3036,3036,0,3036,2887,149,7694,7694,0,0,7694,7649,7467,32,3,141,0,6,45,44,1,0,0,0,7694,43,7651,7694,3781,3913,7467,42,10900
42,13,11001,126358370,3944,1703,1703,0,1703,1555,148,3944,3944,0,0,3944,3932,3911,5,0,13,0,3,12,12,0,0,0,0,3944,6,3938,3944,1962,1982,3911,42,11001
42,13,11002,19471874,4254,1659,1659,0,1659,1575,84,4254,4254,0,0,4254,4238,4180,41,0,14,3,0,16,16,0,0,0,0,4254,7,4247,4254,2163,2091,4180,42,11002
42,13,11100,36857866,6070,2572,2572,0,2572,2462,110,6070,6070,0,0,6070,6041,5993,18,2,21,0,7,29,24,1,0,0,4,6070,29,6041,6070,2930,3140,5993,42,11100
42,13,11200,6149209,5368,2392,2392,0,2392,2224,168,5368,5368,0,0,5368,5341,5271,44,9,14,0,3,27,27,0,0,0,0,5368,26,5342,5368,2519,2849,5271,42,11200
42,13,11300,146333267,5774,2319,2319,0,2319,2230,89,5774,5774,0,0,5774,5753,5740,8,2,2,0,1,21,21,0,0,0,0,5774,17,5757,5774,2729,3045,5740,42,11300
42,13,11400,2073371,2418,1087,1087,0,1087,1019,68,2418,2418,0,0,2418,2412,2392,4,1,9,5,1,6,6,0,0,0,0,2418,1,2417,2418,1158,1260,2392,42,11400
42,13,11500,104907854,5500,2233,2233,0,2233,2111,122,5500,5500,0,0,5500,5470,5440,12,7,7,0,4,30,30,0,0,0,0,5500,11,5489,5500,2787,2713,5440,42,11500
42,13,11600,93019218,3904,1697,1697,0,1697,1549,148,3904,3904,0,0,3904,3880,3863,6,3,1,0,7,24,24,0,0,0,0,3904,14,3890,3904,1866,2038,3863,42,11600
42,13,100200,2804043,2341,1053,1053,0,1053,1028,25,2341,2341,0,0,2341,2330,2317,3,1,4,0,5,11,9,2,0,0,0,2341,8,2333,2341,1100,1241,2317,42,100200
42,13,100300,1208717,3317,1506,1506,0,1506,1380,126,3317,3317,0,0,3317,3285,3188,91,0,5,1,0,32,28,3,0,1,0,3317,6,3311,3317,1554,1763,3188,42,100300
42,13,100400,985402,1831,746,746,0,746,683,63,1831,1831,0,0,1831,1804,1650,147,5,0,0,2,27,26,1,0,0,0,1831,13,1818,1831,879,952,1650,42,100400
42,13,100500,1111521,3665,1522,1522,0,1522,1391,131,3665,3665,0,0,3665,3601,3383,182,5,11,2,18,64,62,2,0,0,0,3665,31,3634,3665,1744,1921,3383,42,100500
42,13,100600,1005860,2936,1207,1207,0,1207,1160,47,2936,2936,0,0,2936,2916,2851,52,5,1,0,7,20,15,5,0,0,0,2936,17,2919,2936,1397,1539,2851,42,100600
42,13,100700,1392314,2630,1043,1043,0,1043,924,119,2630,2630,0,0,2630,2574,2447,101,6,9,0,11,56,53,3,0,0,0,2630,32,2598,2630,1179,1451,2447,42,100700
42,13,100800,989892,2392,647,647,0,647,622,25,2392,2392,0,0,2392,2377,2238,87,1,35,0,16,15,14,0,1,0,0,2392,37,2355,2392,1140,1252,2238,42,100800
42,13,100900,2429441,4596,1934,1934,0,1934,1790,144,4596,4596,0,0,4596,4565,4512,36,3,7,0,7,31,31,0,0,0,0,4596,34,4562,4596,2304,2292,4512,42,100900
42,13,101100,982764,1671,739,739,0,739,703,36,1671,1671,0,0,1671,1660,1617,36,1,5,0,1,11,11,0,0,0,0,1671,5,1666,1671,775,896,1617,42,101100
42,13,101200,3260604,3917,1854,1854,0,1854,1777,77,3917,3917,0,0,3917,3908,3838,41,0,19,0,10,9,9,0,0,0,0,3917,24,3893,3917,1788,2129,3838,42,101200
42,13,101400,1450604,4055,1801,1801,0,1801,1647,154,4055,4055,0,0,4055,4013,3872,101,8,14,4,14,42,36,6,0,0,0,4055,51,4004,4055,1946,2109,3872,42,101400
42,13,101500,2745678,3731,1597,1597,0,1597,1532,65,3731,3731,0,0,3731,3721,3694,11,0,15,0,1,10,10,0,0,0,0,3731,11,3720,3731,1716,2015,3694,42,101500
42,13,101600,1182330,3562,1665,1665,0,1665,1490,175,3562,3562,0,0,3562,3534,3409,111,5,8,1,0,28,26,2,0,0,0,3562,32,3530,3562,1668,1894,3409,42,101600
42,13,101700,1204284,4019,1787,1787,0,1787,1638,149,4019,4019,0,0,4019,3985,3881,76,3,14,0,11,34,31,3,0,0,0,4019,37,3982,4019,1918,2101,3881,42,101700
42,13,101800,2011237,3123,1291,1291,0,1291,1207,84,3123,3123,0,0,3123,3113,3080,15,3,8,0,7,10,10,0,0,0,0,3123,5,3118,3123,1404,1719,3080,42,101800
42,13,101900,581453,1739,1290,1290,0,1290,1088,202,1739,1739,0,0,1739,1728,1570,141,5,1,0,11,11,11,0,0,0,0,1739,24,1715,1739,718,1021,1570,42,101900
42,15,980100,366114833,4187,1997,1997,0,1997,1521,476,4187,4187,0,0,4187,4162,4121,14,12,8,0,7,25,24,1,0,0,0,4187,38,4149,4187,2103,2084,4121,42,980100
42,15,980200,332529168,5177,2256,2256,0,2256,1959,297,5177,5177,0,0,5177,5134,5087,10,26,7,2,2,43,42,1,0,0,0,5177,18,5159,5177,2619,2558,5087,42,980200
42,15,980300,5251653,5813,2722,2722,0,2722,2529,193,5813,5813,0,0,5813,5762,5634,36,10,73,0,9,51,48,3,0,0,0,5813,41,5772,5813,2683,3130,5634,42,980300
42,15,980400,4571264,3415,1500,1500,0,1500,1427,73,3415,3415,0,0,3415,3395,3341,31,5,10,0,8,20,19,1,0,0,0,3415,34,3381,3415,1512,1903,3341,42,980400
42,15,980500,115650782,6045,2620,2620,0,2620,2412,208,6045,6045,0,0,6045,6007,5860,25,17,89,0,16,38,36,2,0,0,0,6045,35,6010,6045,2897,3148,5860,42,980500
42,15,980600,259668787,4521,2051,2051,0,2051,1705,346,4521,4521,0,0,4521,4499,4463,18,9,5,0,4,22,22,0,0,0,0,4521,25,4496,4521,2256,2265,4463,42,980600
42,15,980700,252472718,4681,2033,2033,0,2033,1798,235,4681,4681,0,0,4681,4669,4623,8,8,14,1,15,12,12,0,0,0,0,4681,21,4660,4681,2172,2509,4623,42,980700
42,15,980800,265344884,4045,1779,1779,0,1779,1503,276,4045,4045,0,0,4045,4023,3980,22,14,4,0,3,22,19,3,0,0,0,4045,22,4023,4045,2004,2041,3980,42,980800
42,15,980900,227852594,5514,2465,2465,0,2465,2171,294,5514,5514,0,0,5514,5480,5403,11,28,22,0,16,34,28,5,1,0,0,5514,41,5473,5514,2727,2787,5403,42,980900
42,15,981000,2928739,3024,1459,1459,0,1459,1279,180,3024,3024,0,0,3024,2991,2914,26,11,36,0,4,33,33,0,0,0,0,3024,36,2988,3024,1449,1575,2914,42,981000
42,15,981100,150653969,2977,1326,1326,0,1326,1160,166,2977,2977,0,0,2977,2942,2918,5,10,4,0,5,35,31,4,0,0,0,2977,24,2953,2977,1432,1545,2918,42,981100
42,15,981200,379426229,5137,2709,2709,0,2709,1989,720,5137,5137,0,0,5137,5091,5026,9,30,7,1,18,46,46,0,0,0,0,5137,32,5105,5137,2633,2504,5026,42,981200
42,15,981300,517507963,4148,1990,1990,0,1990,1401,589,4148,4148,0,0,4148,4122,4093,12,9,3,0,5,26,26,0,0,0,0,4148,14,4134,4148,2113,2035,4093,42,981300
42,15,981400,100236580,4077,1757,1757,0,1757,1599,158,4077,4077,0,0,4077,4048,4008,24,4,3,0,9,29,29,0,0,0,0,4077,17,4060,4077,1993,2084,4008,42,981400
42,17,100102,7415247,2771,1391,1391,0,1391,1345,46,2771,2771,0,0,2771,2736,2453,96,6,160,2,19,35,29,6,0,0,0,2771,54,2717,2771,1406,1365,2453,42,100102
42,17,100103,1721885,2420,1085,1085,0,1085,1035,50,2420,2420,0,0,2420,2386,2119,203,11,19,1,33,34,29,5,0,0,0,2420,96,2324,2420,1228,1192,2119,42,100103
42,17,100104,2008699,4475,1810,1810,0,1810,1785,25,4475,4475,0,0,4475,4329,2928,412,19,905,4,61,146,145,1,0,0,0,4475,213,4262,4475,2131,2344,2928,42,100104
42,17,100105,2647110,3406,1239,1239,0,1239,1193,46,3406,3406,0,0,3406,3392,3297,47,4,37,1,6,14,13,1,0,0,0,3406,52,3354,3406,1672,1734,3297,42,100105
42,17,100201,6647276,4322,1707,1707,0,1707,1625,82,4322,4322,0,0,4322,4276,3378,777,11,78,1,31,46,44,2,0,0,0,4322,75,4247,4322,2139,2183,3378,42,100201
42,17,100206,4708235,4447,1818,1818,0,1818,1780,38,4447,4447,0,0,4447,4373,3844,202,3,297,3,24,74,68,5,0,1,0,4447,114,4333,4447,2157,2290,3844,42,100206
42,17,100207,5266832,3842,1507,1507,0,1507,1468,39,3842,3842,0,0,3842,3771,3166,298,7,244,0,56,71,71,0,0,0,0,3842,136,3706,3842,1862,1980,3166,42,100207
42,17,100208,4100529,6441,2648,2648,0,2648,2528,120,6441,6441,0,0,6441,6250,4573,648,12,444,12,561,191,181,7,2,0,1,6441,1159,5282,6441,3485,2956,4573,42,100208
42,17,100209,4815122,7958,3463,3463,0,3463,3255,208,7958,7958,0,0,7958,7802,6205,706,25,795,1,70,156,143,13,0,0,0,7958,261,7697,7958,3966,3992,6205,42,100209
42,17,100210,6665663,7418,2563,2563,0,2563,2507,56,7418,7418,0,0,7418,7330,6648,266,7,377,0,32,88,86,1,0,1,0,7418,128,7290,7418,3684,3734,6648,42,100210
42,17,100211,3040342,6538,2867,2867,0,2867,2685,182,6538,6538,0,0,6538,6451,5826,255,12,302,1,55,87,87,0,0,0,0,6538,136,6402,6538,3138,3400,5826,42,100211
42,17,100212,2674278,4396,1437,1437,0,1437,1421,16,4396,4396,0,0,4396,4371,4006,137,9,202,4,13,25,25,0,0,0,0,4396,81,4315,4396,2200,2196,4006,42,100212
42,17,100302,7070724,5118,1901,1901,0,1901,1811,90,5118,5118,0,0,5118,5085,4954,37,24,26,1,43,33,32,1,0,0,0,5118,112,5006,5118,2641,2477,4954,42,100302
42,17,100303,6252527,5215,1870,1870,0,1870,1794,76,5215,5215,0,0,5215,5073,3242,1581,9,55,0,186,142,131,10,1,0,0,5215,419,4796,5215,2473,2742,3242,42,100303
42,17,100304,4093724,2431,1094,1094,0,1094,1059,35,2431,2431,0,0,2431,2382,1822,422,2,59,3,74,49,43,1,5,0,0,2431,168,2263,2431,1317,1114,1822,42,100304
42,17,100306,1669606,3614,1282,1282,0,1282,1265,17,3614,3614,0,0,3614,3526,2536,340,12,532,1,105,88,88,0,0,0,0,3614,208,3406,3614,1822,1792,2536,42,100306
42,17,100307,2437366,5025,2032,2032,0,2032,1981,51,5025,5025,0,0,5025,4953,4513,253,9,103,0,75,72,67,5,0,0,0,5025,261,4764,5025,2519,2506,4513,42,100307
42,17,100401,3234478,6599,2411,2411,0,2411,2305,106,6599,6599,0,0,6599,6479,5861,371,18,112,1,116,120,112,8,0,0,0,6599,253,6346,6599,3205,3394,5861,42,100401
42,17,100402,3389531,6575,2382,2382,0,2382,2345,37,6575,6575,0,0,6575,6500,6173,212,8,44,3,60,75,73,2,0,0,0,6575,194,6381,6575,3234,3341,6173,42,100402
42,17,100403,4183821,2227,828,828,0,828,803,25,2227,2227,0,0,2227,2208,1233,944,2,4,0,25,19,15,4,0,0,0,2227,47,2180,2227,1045,1182,1233,42,100403
42,17,100404,2963648,6307,2394,2394,0,2394,2234,160,6307,6307,0,0,6307,6220,5834,237,6,47,11,85,87,80,7,0,0,0,6307,178,6129,6307,3079,3228,5834,42,100404
42,17,100406,2804316,4004,1487,1487,0,1487,1369,118,4004,4004,0,0,4004,3954,3574,182,5,159,0,34,50,39,11,0,0,0,4004,124,3880,4004,1930,2074,3574,42,100406
42,17,100407,661410,1387,483,483,0,483,476,7,1387,1387,0,0,1387,1378,1339,21,0,5,0,13,9,9,0,0,0,0,1387,23,1364,1387,685,702,1339,42,100407
42,17,100408,3048080,7019,2322,2322,0,2322,2291,31,7019,7019,0,0,7019,6937,6737,90,20,42,1,47,82,81,1,0,0,0,7019,152,6867,7019,3479,3540,6737,42,100408
42,17,100500,1479402,2631,1123,1123,0,1123,1087,36,2631,2631,0,0,2631,2594,2503,28,6,6,0,51,37,37,0,0,0,0,2631,115,2516,2631,1306,1325,2503,42,100500
42,17,100600,886440,3949,1892,1892,0,1892,1775,117,3949,3949,0,0,3949,3850,3371,284,4,17,2,172,99,94,5,0,0,0,3949,467,3482,3949,1849,2100,3371,42,100600
42,17,100700,1905796,3343,1192,1192,0,1192,1142,50,3343,3343,0,0,3343,3209,2408,560,5,11,1,224,134,130,4,0,0,0,3343,562,2781,3343,1563,1780,2408,42,100700
42,17,100803,3092786,4865,1735,1735,0,1735,1712,23,4865,4865,0,0,4865,4806,4589,79,15,87,0,36,59,58,1,0,0,0,4865,90,4775,4865,2417,2448,4589,42,100803
42,17,100804,2574884,3773,1189,1189,0,1189,1174,15,3773,3773,0,0,3773,3746,3631,54,4,39,0,18,27,26,1,0,0,0,3773,46,3727,3773,1882,1891,3631,42,100804
42,17,100805,3875864,6281,2185,2185,0,2185,2158,27,6281,6281,0,0,6281,6238,6059,71,12,68,0,28,43,43,0,0,0,0,6281,83,6198,6281,3038,3243,6059,42,100805
42,17,100807,8716835,3169,1152,1152,0,1152,1055,97,3169,3169,0,0,3169,3150,3002,44,3,80,1,20,19,19,0,0,0,0,3169,36,3133,3169,1387,1782,3002,42,100807
42,17,100808,9315838,5342,1878,1878,0,1878,1857,21,5342,5342,0,0,5342,5314,5125,38,2,129,0,20,28,27,1,0,0,0,5342,61,5281,5342,2546,2796,5125,42,100808
42,17,100809,7876689,4944,1438,1438,0,1438,1431,7,4944,4944,0,0,4944,4900,4634,82,0,173,1,10,44,42,2,0,0,0,4944,64,4880,4944,2488,2456,4634,42,100809
42,17,100810,2601154,3473,1349,1349,0,1349,1290,59,3473,3473,0,0,3473,3453,3245,88,8,101,0,11,20,20,0,0,0,0,3473,47,3426,3473,1672,1801,3245,42,100810
42,17,100811,1924485,4461,2053,2053,0,2053,1976,77,4461,4461,0,0,4461,4364,3662,361,15,258,0,68,97,94,3,0,0,0,4461,205,4256,4461,2146,2315,3662,42,100811
42,17,100900,9523870,7833,2734,2734,0,2734,2668,66,7833,7833,0,0,7833,7759,7485,110,6,126,0,32,74,64,10,0,0,0,7833,125,7708,7833,3922,3911,7485,42,100900
42,17,101000,997216,893,356,356,0,356,339,17,893,893,0,0,893,887,870,3,4,9,0,1,6,6,0,0,0,0,893,4,889,893,445,448,870,42,101000
42,17,101100,1131052,2420,927,927,0,927,900,27,2420,2420,0,0,2420,2398,2226,73,3,79,2,15,22,20,0,2,0,0,2420,47,2373,2420,1149,1271,2226,42,101100
42,17,101200,1539348,927,336,336,0,336,330,6,927,927,0,0,927,922,874,30,1,13,0,4,5,5,0,0,0,0,927,10,917,927,451,476,874,42,101200
42,17,101300,1277471,1981,649,649,0,649,552,97,1981,1981,0,0,1981,1963,1615,301,3,29,0,15,18,17,0,1,0,0,1981,52,1929,1981,1070,911,1615,42,101300
42,17,101401,5925469,3987,1513,1513,0,1513,1498,15,3987,3987,0,0,3987,3952,3880,10,6,44,0,12,35,35,0,0,0,0,3987,40,3947,3987,1963,2024,3880,42,101401
42,17,101403,4718493,6315,2288,2288,0,2288,2227,61,6315,6315,0,0,6315,6287,6170,35,2,56,0,24,28,25,3,0,0,0,6315,46,6269,6315,3097,3218,6170,42,101403
42,17,101404,3202132,2449,882,882,0,882,849,33,2449,2449,0,0,2449,2437,2362,23,1,34,0,17,12,12,0,0,0,0,2449,37,2412,2449,1175,1274,2362,42,101404
42,17,101405,3442339,6525,2650,2650,0,2650,2578,72,6525,6525,0,0,6525,6460,6159,139,3,130,2,27,65,61,4,0,0,0,6525,149,6376,6525,3274,3251,6159,42,101405
42,17,101503,5162672,3964,1559,1559,0,1559,1546,13,3964,3964,0,0,3964,3938,3818,28,3,83,0,6,26,17,9,0,0,0,3964,41,3923,3964,1920,2044,3818,42,101503
42,17,101504,2553347,2977,1313,1313,0,1313,1279,34,2977,2977,0,0,2977,2965,2905,14,0,43,1,2,12,8,4,0,0,0,2977,15,2962,2977,1301,1676,2905,42,101504
42,17,101505,4739865,3411,1166,1166,0,1166,1158,8,3411,3411,0,0,3411,3378,3286,31,1,54,0,6,33,33,0,0,0,0,3411,21,3390,3411,1697,1714,3286,42,101505
42,17,101506,4666675,5412,2085,2085,0,2085,2048,37,5412,5412,0,0,5412,5391,5261,49,6,57,2,16,21,21,0,0,0,0,5412,50,5362,5412,2673,2739,5261,42,101506
42,17,101603,2011111,3075,1222,1222,0,1222,1186,36,3075,3075,0,0,3075,3037,2927,28,0,39,3,40,38,32,6,0,0,0,3075,80,2995,3075,1515,1560,2927,42,101603
42,17,101605,2133113,4196,1649,1649,0,1649,1525,124,4196,4196,0,0,4196,4005,2744,548,18,166,1,528,191,183,7,1,0,0,4196,1007,3189,4196,2063,2133,2744,42,101605
42,17,101607,2663614,3160,1391,1391,0,1391,1352,39,3160,3160,0,0,3160,3140,3062,31,2,33,0,12,20,19,1,0,0,0,3160,37,3123,3160,1450,1710,3062,42,101607
42,17,101608,5420486,4632,1564,1564,0,1564,1546,18,4632,4632,0,0,4632,4553,4161,216,4,130,4,38,79,68,11,0,0,0,4632,105,4527,4632,2320,2312,4161,42,101608
42,17,101609,4482068,4753,1736,1736,0,1736,1721,15,4753,4753,0,0,4753,4734,4581,48,4,74,2,25,19,18,1,0,0,0,4753,61,4692,4753,2334,2419,4581,42,101609
42,17,101610,4782973,4903,1790,1790,0,1790,1744,46,4903,4903,0,0,4903,4879,4687,83,2,77,5,25,24,21,3,0,0,0,4903,67,4836,4903,2400,2503,4687,42,101610
42,17,101611,5060424,6664,2292,2292,0,2292,2276,16,6664,6664,0,0,6664,6622,6396,84,5,105,5,27,42,40,2,0,0,0,6664,97,6567,6664,3265,3399,6396,42,101611
42,17,101700,796291,492,199,199,0,199,194,5,492,492,0,0,492,490,470,0,5,14,0,1,2,1,1,0,0,0,492,9,483,492,234,258,470,42,101700
42,17,101802,12969514,4128,1394,1394,0,1394,1315,79,4128,4128,0,0,4128,4104,3891,54,1,134,6,18,24,21,3,0,0,0,4128,36,4092,4128,2109,2019,3891,42,101802
42,17,101803,14590723,4941,1720,1720,0,1720,1686,34,4941,4941,0,0,4941,4910,4721,86,2,84,1,16,31,30,1,0,0,0,4941,61,4880,4941,2494,2447,4721,42,101803
42,17,101804,8101093,8511,3200,3200,0,3200,3123,77,8511,8511,0,0,8511,8435,7941,199,9,221,6,59,76,69,3,4,0,0,8511,178,8333,8511,4196,4315,7941,42,101804
42,17,101900,4269566,3900,1404,1404,0,1404,1382,22,3900,3900,0,0,3900,3870,3766,41,3,58,0,2,30,29,1,0,0,0,3900,45,3855,3900,1919,1981,3766,42,101900
42,17,102002,20276747,2834,962,962,0,962,936,26,2834,2834,0,0,2834,2822,2718,50,8,37,0,9,12,11,1,0,0,0,2834,33,2801,2834,1396,1438,2718,42,102002
42,17,102003,12494456,3782,1301,1301,0,1301,1284,17,3782,3782,0,0,3782,3753,3652,43,4,46,0,8,29,26,0,3,0,0,3782,53,3729,3782,1899,1883,3652,42,102003
42,17,102004,5307853,4082,1706,1706,0,1706,1675,31,4082,4082,0,0,4082,4048,3928,51,1,39,0,29,34,34,0,0,0,0,4082,51,4031,4082,1926,2156,3928,42,102004
42,17,102102,27694985,3130,1112,1112,0,1112,1092,20,3130,3130,0,0,3130,3108,3066,19,5,15,2,1,22,21,1,0,0,0,3130,18,3112,3130,1564,1566,3066,42,102102
42,17,102103,20441073,3973,1345,1345,0,1345,1327,18,3973,3973,0,0,3973,3952,3891,32,1,28,0,0,21,17,4,0,0,0,3973,26,3947,3973,1958,2015,3891,42,102103
42,17,102104,21563288,4999,1913,1913,0,1913,1856,57,4999,4999,0,0,4999,4922,4654,135,5,88,1,39,77,56,20,1,0,0,4999,133,4866,4999,2451,2548,4654,42,102104
42,17,102200,1167819,1001,329,329,0,329,323,6,1001,1001,0,0,1001,998,991,2,1,1,0,3,3,3,0,0,0,0,1001,8,993,1001,528,473,991,42,102200
42,17,102300,33538435,5199,1883,1883,0,1883,1828,55,5199,5199,0,0,5199,5149,5053,42,21,20,3,10,50,48,2,0,0,0,5199,65,5134,5199,2626,2573,5053,42,102300
42,17,102400,6707214,8828,3378,3378,0,3378,3294,84,8828,8828,0,0,8828,8776,8631,52,14,47,0,32,52,46,6,0,0,0,8828,120,8708,8828,4385,4443,8631,42,102400
42,17,102500,3004705,4564,1827,1827,0,1827,1770,57,4564,4564,0,0,4564,4514,4441,26,7,16,2,22,50,47,3,0,0,0,4564,91,4473,4564,2295,2269,4441,42,102500
42,17,102600,1372929,2211,1015,1015,0,1015,988,27,2211,2211,0,0,2211,2199,2092,34,1,52,0,20,12,12,0,0,0,0,2211,72,2139,2211,957,1254,2092,42,102600
42,17,102700,42212928,4233,1701,1701,0,1701,1636,65,4233,4233,0,0,4233,4213,4158,23,6,20,0,6,20,20,0,0,0,0,4233,25,4208,4233,2051,2182,4158,42,102700
42,17,102801,28270451,3096,1093,1093,0,1093,1057,36,3096,3096,0,0,3096,3082,3018,21,2,25,1,15,14,12,2,0,0,0,3096,19,3077,3096,1602,1494,3018,42,102801
42,17,102802,44399425,5714,2068,2068,0,2068,2016,52,5714,5714,0,0,5714,5685,5594,40,6,32,0,13,29,28,1,0,0,0,5714,71,5643,5714,2782,2932,5594,42,102802
42,17,102900,1108121,1059,382,382,0,382,374,8,1059,1059,0,0,1059,1055,1037,6,0,7,0,5,4,4,0,0,0,0,1059,9,1050,1059,521,538,1037,42,102900
42,17,103001,20671385,4694,1881,1881,0,1881,1819,62,4694,4694,0,0,4694,4636,4488,52,7,66,0,23,58,56,2,0,0,0,4694,68,4626,4694,2322,2372,4488,42,103001
42,17,103002,32323072,5226,1996,1996,0,1996,1944,52,5226,5226,0,0,5226,5178,5070,40,4,49,0,15,48,47,1,0,0,0,5226,63,5163,5226,2584,2642,5070,42,103002
42,17,103101,1132052,2478,987,987,0,987,949,38,2478,2478,0,0,2478,2459,2395,30,2,19,0,13,19,19,0,0,0,0,2478,38,2440,2478,1250,1228,2395,42,103101
42,17,103102,1544839,2080,879,879,0,879,842,37,2080,2080,0,0,2080,2055,1939,27,4,27,4,54,25,24,1,0,0,0,2080,84,1996,2080,1044,1036,1939,42,103102
42,17,103103,2560511,4373,1765,1765,0,1765,1630,135,4373,4373,0,0,4373,4322,4102,50,6,89,1,74,51,48,3,0,0,0,4373,135,4238,4373,2077,2296,4102,42,103103
42,17,103200,660073,1283,451,451,0,451,430,21,1283,1283,0,0,1283,1277,1261,5,0,6,0,5,6,6,0,0,0,0,1283,16,1267,1283,597,686,1261,42,103200
42,17,103300,51989416,2191,841,841,0,841,805,36,2191,2191,0,0,2191,2184,2147,8,2,20,5,2,7,6,1,0,0,0,2191,6,2185,2191,1130,1061,2147,42,103300
42,17,103400,79721587,4963,1972,1972,0,1972,1900,72,4963,4963,0,0,4963,4943,4894,30,5,5,0,9,20,20,0,0,0,0,4963,43,4920,4963,2485,2478,4894,42,103400
42,17,103500,23843718,1313,525,525,0,525,485,40,1313,1313,0,0,1313,1303,1289,1,0,10,0,3,10,8,2,0,0,0,1313,14,1299,1313,701,612,1289,42,103500
42,17,103600,2575532,863,403,403,0,403,378,25,863,863,0,0,863,862,856,1,0,2,0,3,1,1,0,0,0,0,863,5,858,863,432,431,856,42,103600
42,17,103700,57477511,3517,1411,1411,0,1411,1337,74,3517,3517,0,0,3517,3489,3457,18,1,4,4,5,28,24,4,0,0,0,3517,21,3496,3517,1808,1709,3457,42,103700
42,17,103800,16764206,1408,612,612,0,612,559,53,1408,1408,0,0,1408,1407,1396,6,1,4,0,0,1,1,0,0,0,0,1408,12,1396,1408,702,706,1396,42,103800
42,17,103900,78227732,4206,1834,1834,0,1834,1674,160,4206,4206,0,0,4206,4169,4090,32,7,17,2,21,37,36,1,0,0,0,4206,57,4149,4206,2189,2017,4090,42,103900
42,17,104000,78103688,4804,1868,1868,0,1868,1788,80,4804,4804,0,0,4804,4773,4714,28,1,20,1,9,31,31,0,0,0,0,4804,44,4760,4804,2441,2363,4714,42,104000
42,17,104100,1410180,2083,869,869,0,869,851,18,2083,2083,0,0,2083,2053,1981,31,4,24,3,10,30,29,1,0,0,0,2083,39,2044,2083,1034,1049,1981,42,104100
42,17,104200,70346273,11409,4103,4103,0,4103,3938,165,11409,11409,0,0,11409,11320,10994,81,32,115,1,97,89,87,0,2,0,0,11409,226,11183,11409,5732,5677,10994,42,104200
42,17,104300,68998036,7743,3207,3207,0,3207,3053,154,7743,7743,0,0,7743,7684,7520,49,15,66,7,27,59,57,2,0,0,0,7743,112,7631,7743,3858,3885,7520,42,104300
42,17,104400,3293594,2252,1251,1251,0,1251,1160,91,2252,2252,0,0,2252,2229,2138,25,5,19,0,42,23,23,0,0,0,0,2252,125,2127,2252,1205,1047,2138,42,104400
42,17,104501,36272470,12136,4041,4041,0,4041,3937,104,12136,12136,0,0,12136,12055,11685,155,18,163,2,32,81,71,6,0,4,0,12136,184,11952,12136,5990,6146,11685,42,104501
42,17,104502,49408527,4306,1820,1820,0,1820,1774,46,4306,4306,0,0,4306,4282,4222,16,1,32,0,11,24,22,2,0,0,0,4306,36,4270,4306,2017,2289,4222,42,104502
42,17,104601,13274956,4752,1716,1716,0,1716,1694,22,4752,4752,0,0,4752,4726,4626,38,1,60,0,1,26,26,0,0,0,0,4752,41,4711,4752,2333,2419,4626,42,104601
42,17,104603,15159743,6201,1834,1834,0,1834,1785,49,6201,6201,0,0,6201,6164,5685,355,4,94,1,25,37,33,1,3,0,0,6201,119,6082,6201,3254,2947,5685,42,104603
42,17,104604,11388240,6657,2647,2647,0,2647,2517,130,6657,6657,0,0,6657,6607,6457,64,6,67,3,10,50,45,5,0,0,0,6657,87,6570,6657,3068,3589,6457,42,104604
42,17,104701,2319431,3089,1788,1788,0,1788,1755,33,3089,3089,0,0,3089,3066,2939,37,2,73,1,14,23,21,1,1,0,0,3089,33,3056,3089,1258,1831,2939,42,104701
42,17,104702,1402872,2745,1304,1304,0,1304,1254,50,2745,2745,0,0,2745,2734,2651,55,1,13,2,12,11,11,0,0,0,0,2745,39,2706,2745,1270,1475,2651,42,104702
42,17,104703,2173527,2402,966,966,0,966,946,20,2402,2402,0,0,2402,2384,2320,15,6,31,3,9,18,17,1,0,0,0,2402,27,2375,2402,1117,1285,2320,42,104703
42,17,104800,3298068,3125,930,930,0,930,912,18,3125,3125,0,0,3125,3096,2996,64,2,25,1,8,29,29,0,0,0,0,3125,51,3074,3125,1478,1647,2996,42,104800
42,17,104901,11025783,6302,2000,2000,0,2000,1927,73,6302,6302,0,0,6302,6270,6070,53,7,130,1,9,32,31,1,0,0,0,6302,43,6259,6302,3126,3176,6070,42,104901
42,17,104902,17822697,5675,2050,2050,0,2050,2006,44,5675,5675,0,0,5675,5630,5420,71,1,126,5,7,45,45,0,0,0,0,5675,80,5595,5675,2758,2917,5420,42,104902
42,17,105003,12535768,5033,1589,1589,0,1589,1582,7,5033,5033,0,0,5033,5002,4924,13,0,65,0,0,31,31,0,0,0,0,5033,30,5003,5033,2450,2583,4924,42,105003
42,17,105004,8802472,5627,1771,1771,0,1771,1763,8,5627,5627,0,0,5627,5603,5519,18,1,61,0,4,24,22,2,0,0,0,5627,33,5594,5627,2750,2877,5519,42,105004
42,17,105006,9386970,5974,1934,1934,0,1934,1911,23,5974,5974,0,0,5974,5942,5792,15,0,129,3,3,32,32,0,0,0,0,5974,41,5933,5974,2964,3010,5792,42,105006
42,17,105007,10315541,8404,2653,2653,0,2653,2638,15,8404,8404,0,0,8404,8353,8161,39,2,140,0,11,51,46,1,3,1,0,8404,58,8346,8404,4132,4272,8161,42,105007
42,17,105008,16407359,2954,898,898,0,898,888,10,2954,2954,0,0,2954,2951,2889,9,1,49,0,3,3,3,0,0,0,0,2954,28,2926,2954,1463,1491,2889,42,105008
42,17,105009,2566487,3620,1613,1613,0,1613,1576,37,3620,3620,0,0,3620,3588,3504,25,5,34,0,20,32,31,1,0,0,0,3620,39,3581,3620,1616,2004,3504,42,105009
42,17,105010,3127076,3950,1354,1354,0,1354,1341,13,3950,3950,0,0,3950,3927,3792,14,1,114,0,6,23,23,0,0,0,0,3950,47,3903,3950,1908,2042,3792,42,105010
42,17,105011,3760865,3822,1326,1326,0,1326,1315,11,3822,3822,0,0,3822,3791,3624,30,4,116,0,17,31,26,5,0,0,0,3822,49,3773,3822,1849,1973,3624,42,105011
42,17,105100,25711553,2839,986,986,0,986,971,15,2839,2839,0,0,2839,2822,2752,24,1,43,0,2,17,16,1,0,0,0,2839,17,2822,2839,1398,1441,2752,42,105100
42,17,105202,6336584,5312,2226,2226,0,2226,2205,21,5312,5312,0,0,5312,5255,4982,48,0,212,0,13,57,55,2,0,0,0,5312,65,5247,5312,2497,2815,4982,42,105202
42,17,105203,8483086,2063,704,704,0,704,696,8,2063,2063,0,0,2063,2049,1948,47,1,53,0,0,14,13,1,0,0,0,2063,29,2034,2063,1024,1039,1948,42,105203
42,17,105204,16149832,10831,3918,3918,0,3918,3860,58,10831,10831,0,0,10831,10726,10122,96,6,469,0,33,105,91,11,1,2,0,10831,148,10683,10831,5260,5571,10122,42,105204
42,17,105300,1425191,2312,936,936,0,936,920,16,2312,2312,0,0,2312,2290,2241,26,2,17,0,4,22,20,2,0,0,0,2312,22,2290,2312,1043,1269,2241,42,105300
42,17,105400,54207455,7180,2598,2598,0,2598,2512,86,7180,7180,0,0,7180,7144,6973,58,5,91,0,17,36,34,2,0,0,0,7180,81,7099,7180,3529,3651,6973,42,105400
42,17,105501,20625318,8153,2520,2520,0,2520,2462,58,8153,8153,0,0,8153,8063,7525,121,3,390,0,24,90,83,3,0,4,0,8153,122,8031,8153,4039,4114,7525,42,105501
42,17,105503,7500802,9146,4085,4085,0,4085,3989,96,9146,9146,0,0,9146,9088,8423,258,12,366,0,29,58,53,5,0,0,0,9146,167,8979,9146,4360,4786,8423,42,105503
42,17,105505,5265749,3934,1512,1512,0,1512,1478,34,3934,3934,0,0,3934,3908,3805,35,1,54,1,12,26,25,1,0,0,0,3934,33,3901,3934,1921,2013,3805,42,105505
42,17,105506,5702908,4110,1260,1260,0,1260,1252,8,4110,4110,0,0,4110,4083,3765,88,8,204,0,18,27,27,0,0,0,0,4110,59,4051,4110,2008,2102,3765,42,105506
42,17,105507,7366602,7338,2554,2554,0,2554,2525,29,7338,7338,0,0,7338,7285,6980,90,0,203,0,12,53,46,7,0,0,0,7338,82,7256,7338,3610,3728,6980,42,105507
42,17,105600,2370773,2498,1209,1209,0,1209,1170,39,2498,2498,0,0,2498,2471,2339,86,2,30,1,13,27,25,1,1,0,0,2498,44,2454,2498,1188,1310,2339,42,105600
42,17,105702,2295716,3326,1487,1487,0,1487,1409,78,3326,3326,0,0,3326,3266,2975,216,11,16,0,48,60,51,9,0,0,0,3326,122,3204,3326,1664,1662,2975,42,105702
42,17,105704,2291607,6697,2826,2826,0,2826,2745,81,6697,6697,0,0,6697,6613,4640,1702,7,104,0,160,84,77,6,1,0,0,6697,361,6336,6697,3128,3569,4640,42,105704
42,17,105801,9507201,6807,2575,2575,0,2575,2527,48,6807,6807,0,0,6807,6700,5226,1003,7,367,0,97,107,96,11,0,0,0,6807,263,6544,6807,3349,3458,5226,42,105801
42,17,105805,10306750,5808,2610,2610,0,2610,2446,164,5808,5808,0,0,5808,5721,5306,197,15,158,1,44,87,78,9,0,0,0,5808,126,5682,5808,2828,2980,5306,42,105805
42,17,105806,26419373,103,45,45,0,45,38,7,103,103,0,0,103,103,102,0,0,1,0,0,0,0,0,0,0,0,103,1,102,103,54,49,102,42,105806
42,17,105807,1608348,3506,1533,1533,0,1533,1494,39,3506,3506,0,0,3506,3425,3003,232,13,149,0,28,81,74,7,0,0,0,3506,102,3404,3506,1637,1869,3003,42,105807
42,17,105808,2384905,3643,1437,1437,0,1437,1392,45,3643,3643,0,0,3643,3608,3497,25,5,57,0,24,35,35,0,0,0,0,3643,83,3560,3643,1757,1886,3497,42,105808
42,17,105809,3129303,4480,1584,1584,0,1584,1567,17,4480,4480,0,0,4480,4429,4245,57,5,95,0,27,51,50,1,0,0,0,4480,96,4384,4480,2195,2285,4245,42,105809
42,17,105810,1261029,2668,1003,1003,0,1003,995,8,2668,2668,0,0,2668,2637,2531,60,0,16,0,30,31,27,4,0,0,0,2668,51,2617,2668,1302,1366,2531,42,105810
42,17,105811,2253914,6132,2150,2150,0,2150,2125,25,6132,6132,0,0,6132,6065,5863,127,9,52,6,8,67,64,1,2,0,0,6132,77,6055,6132,3020,3112,5863,42,105811
42,17,105812,829733,1718,591,591,0,591,586,5,1718,1718,0,0,1718,1700,1681,3,1,4,0,11,18,17,1,0,0,0,1718,19,1699,1718,833,885,1681,42,105812
42,17,105900,4080345,2031,819,819,0,819,803,16,2031,2031,0,0,2031,2028,1985,30,1,10,0,2,3,3,0,0,0,0,2031,28,2003,2031,978,1053,1985,42,105900
42,19,902100,1039451,2473,1267,1267,0,1267,1175,92,2473,2473,0,0,2473,2450,2406,26,3,10,1,4,23,20,3,0,0,0,2473,23,2450,2473,1134,1339,2406,42,902100
42,19,902200,1447497,2069,1059,1059,0,1059,937,122,2069,2069,0,0,2069,2061,2033,23,2,3,0,0,8,8,0,0,0,0,2069,21,2048,2069,954,1115,2033,42,902200
42,19,902300,1777989,3764,1698,1698,0,1698,1556,142,3764,3764,0,0,3764,3711,3517,126,5,22,0,41,53,48,5,0,0,0,3764,85,3679,3764,1831,1933,3517,42,902300
42,19,902400,1043852,2698,1413,1413,0,1413,1279,134,2698,2698,0,0,2698,2669,2568,76,7,10,0,8,29,29,0,0,0,0,2698,40,2658,2698,1248,1450,2568,42,902400
42,19,902500,1670552,4117,1965,1965,0,1965,1793,172,4117,4117,0,0,4117,4058,3920,84,4,21,3,26,59,56,3,0,0,0,4117,46,4071,4117,1916,2201,3920,42,902500
42,19,902600,5093356,3229,1269,1269,0,1269,1232,37,3229,3229,0,0,3229,3213,3181,23,3,6,0,0,16,16,0,0,0,0,3229,4,3225,3229,1532,1697,3181,42,902600
42,19,902700,2987801,2076,1033,1033,0,1033,960,73,2076,2076,0,0,2076,2055,2039,9,2,2,0,3,21,19,2,0,0,0,2076,13,2063,2076,1025,1051,2039,42,902700
42,19,902800,6487521,2911,1476,1476,0,1476,1405,71,2911,2911,0,0,2911,2893,2835,25,0,32,0,1,18,17,1,0,0,0,2911,4,2907,2911,1378,1533,2835,42,902800
42,19,902900,8214973,1675,728,728,0,728,694,34,1675,1675,0,0,1675,1671,1642,9,0,12,3,5,4,4,0,0,0,0,1675,11,1664,1675,807,868,1642,42,902900
42,19,903000,20702895,4660,1905,1905,0,1905,1850,55,4660,4660,0,0,4660,4648,4614,14,3,12,4,1,12,12,0,0,0,0,4660,18,4642,4660,2291,2369,4614,42,903000
42,19,903100,12202315,2634,1089,1089,0,1089,1060,29,2634,2634,0,0,2634,2624,2593,12,1,14,2,2,10,10,0,0,0,0,2634,17,2617,2634,1261,1373,2593,42,903100
42,19,910100,192873481,4532,1947,1947,0,1947,1683,264,4532,4532,0,0,4532,4516,4486,15,3,4,6,2,16,15,0,0,1,0,4532,12,4520,4532,2240,2292,4486,42,910100
42,19,910200,262490861,4961,2044,2044,0,2044,1829,215,4961,4961,0,0,4961,4945,4898,15,14,8,8,2,16,13,3,0,0,0,4961,22,4939,4961,2522,2439,4898,42,910200
42,19,910300,217285256,8578,3567,3567,0,3567,3224,343,8578,8578,0,0,8578,8519,8429,43,6,26,0,15,59,53,6,0,0,0,8578,41,8537,8578,4251,4327,8429,42,910300
42,19,910400,4145137,2706,993,993,0,993,935,58,2706,2706,0,0,2706,2671,2460,92,5,94,2,18,35,34,1,0,0,0,2706,29,2677,2706,1274,1432,2460,42,910400
42,19,910500,1628683,2209,64,64,0,64,59,5,2209,2209,0,0,2209,2190,2037,97,1,47,0,8,19,17,2,0,0,0,2209,24,2185,2209,932,1277,2037,42,910500
42,19,910600,129877489,4225,1685,1685,0,1685,1591,94,4225,4225,0,0,4225,4205,4191,7,0,3,0,4,20,16,3,1,0,0,4225,23,4202,4225,2111,2114,4191,42,910600
42,19,910700,59382333,3074,1168,1168,0,1168,1112,56,3074,3074,0,0,3074,3071,3060,3,5,3,0,0,3,3,0,0,0,0,3074,2,3072,3074,1561,1513,3060,42,910700
42,19,910800,45929533,3357,1389,1389,0,1389,1336,53,3357,3357,0,0,3357,3345,3303,17,2,15,0,8,12,12,0,0,0,0,3357,7,3350,3357,1703,1654,3303,42,910800
42,19,910900,17390818,4825,2093,2093,0,2093,1997,96,4825,4825,0,0,4825,4802,4737,19,1,32,1,12,23,23,0,0,0,0,4825,21,4804,4825,2241,2584,4737,42,910900
42,19,911000,124792786,6061,2480,2480,0,2480,2395,85,6061,6061,0,0,6061,6030,5994,6,9,10,6,5,31,31,0,0,0,0,6061,23,6038,6061,3051,3010,5994,42,911000
42,19,911100,61859087,4217,1662,1662,0,1662,1585,77,4217,4217,0,0,4217,4206,4180,5,6,9,1,5,11,11,0,0,0,0,4217,25,4192,4217,2131,2086,4180,42,911100
42,19,911200,60445145,5407,2057,2057,0,2057,1977,80,5407,5407,0,0,5407,5391,5189,188,1,11,1,1,16,16,0,0,0,0,5407,38,5369,5407,2871,2536,5189,42,911200
42,19,911300,121475608,5448,2044,2044,0,2044,1934,110,5448,5448,0,0,5448,5431,5400,13,9,3,0,6,17,15,2,0,0,0,5448,23,5425,5448,2675,2773,5400,42,911300
42,19,911400,63241123,3585,1381,1381,0,1381,1335,46,3585,3585,0,0,3585,3574,3552,6,6,3,1,6,11,11,0,0,0,0,3585,10,3575,3585,1752,1833,3552,42,911400
42,19,911501,60568340,5690,1970,1970,0,1970,1916,54,5690,5690,0,0,5690,5677,5659,9,0,3,0,6,13,13,0,0,0,0,5690,15,5675,5690,2615,3075,5659,42,911501
42,19,911502,63964522,4408,1788,1788,0,1788,1698,90,4408,4408,0,0,4408,4374,4357,8,1,3,0,5,34,30,4,0,0,0,4408,36,4372,4408,2091,2317,4357,42,911502
42,19,911600,62539294,5210,1980,1980,0,1980,1896,84,5210,5210,0,0,5210,5193,5145,13,3,28,2,2,17,17,0,0,0,0,5210,22,5188,5210,2630,2580,5145,42,911600
42,19,911700,62525395,4696,1939,1939,0,1939,1789,150,4696,4696,0,0,4696,4685,4645,8,8,20,1,3,11,11,0,0,0,0,4696,10,4686,4696,2389,2307,4645,42,911700
42,19,911800,115350896,6156,2371,2371,0,2371,2264,107,6156,6156,0,0,6156,6126,6059,39,3,16,1,8,30,29,1,0,0,0,6156,22,6134,6156,3080,3076,6059,42,911800
42,19,911900,6492996,5060,2547,2547,0,2547,2365,182,5060,5060,0,0,5060,5026,4966,21,5,27,0,7,34,34,0,0,0,0,5060,19,5041,5060,2343,2717,4966,42,911900
42,19,912000,23369116,7800,3082,3082,0,3082,2910,172,7800,7800,0,0,7800,7735,7460,76,8,163,1,27,65,60,5,0,0,0,7800,68,7732,7800,3834,3966,7460,42,912000
42,19,912101,3335869,3909,1434,1434,0,1434,1399,35,3909,3909,0,0,3909,3892,3790,48,2,49,1,2,17,15,2,0,0,0,3909,13,3896,3909,1899,2010,3790,42,912101
42,19,912102,1915508,2953,1108,1108,0,1108,1078,30,2953,2953,0,0,2953,2937,2891,16,1,24,0,5,16,16,0,0,0,0,2953,21,2932,2953,1437,1516,2891,42,912102
42,19,912200,4255472,2965,1043,1043,0,1043,1010,33,2965,2965,0,0,2965,2950,2893,25,0,28,0,4,15,15,0,0,0,0,2965,24,2941,2965,1433,1532,2893,42,912200
42,19,912300,28321890,7984,2884,2884,0,2884,2712,172,7984,7984,0,0,7984,7920,7733,57,4,111,3,12,64,61,3,0,0,0,7984,71,7913,7984,3992,3992,7733,42,912300
42,19,912400,62138929,9348,3529,3529,0,3529,3326,203,9348,9348,0,0,9348,9307,9153,64,3,65,5,17,41,40,1,0,0,0,9348,60,9288,9348,4428,4920,9153,42,912400
42,19,912700,62548524,6827,2612,2612,0,2612,2521,91,6827,6827,0,0,6827,6808,6763,16,8,20,0,1,19,16,3,0,0,0,6827,15,6812,6827,3394,3433,6763,42,912700
42,19,912800,59480574,5586,2105,2105,0,2105,2045,60,5586,5586,0,0,5586,5564,5524,14,5,9,1,11,22,22,0,0,0,0,5586,38,5548,5586,2752,2834,5524,42,912800
42,21,100,549703,1363,1128,1128,0,1128,941,187,1363,1363,0,0,1363,1351,1234,106,3,2,1,5,12,12,0,0,0,0,1363,26,1337,1363,560,803,1234,42,100
42,21,200,989803,1442,823,823,0,823,616,207,1442,1442,0,0,1442,1403,934,426,3,1,4,35,39,35,4,0,0,0,1442,39,1403,1442,691,751,934,42,200
42,21,300,974198,2273,1170,1170,0,1170,974,196,2273,2273,0,0,2273,2185,1647,510,3,3,1,21,88,79,5,4,0,0,2273,50,2223,2273,1035,1238,1647,42,300
42,21,400,1266260,1160,569,569,0,569,503,66,1160,1160,0,0,1160,1134,1063,67,2,1,0,1,26,25,1,0,0,0,1160,11,1149,1160,564,596,1063,42,400
42,21,500,893175,1963,1046,1046,0,1046,922,124,1963,1963,0,0,1963,1930,1842,71,1,2,0,14,33,33,0,0,0,0,1963,37,1926,1963,909,1054,1842,42,500
42,21,600,876976,2310,1149,1149,0,1149,1013,136,2310,2310,0,0,2310,2285,2177,95,5,1,4,3,25,25,0,0,0,0,2310,22,2288,2310,1071,1239,2177,42,600
42,21,700,2010163,3028,1546,1546,0,1546,1413,133,3028,3028,0,0,3028,2996,2872,70,3,40,0,11,32,31,1,0,0,0,3028,42,2986,3028,1396,1632,2872,42,700
42,21,800,589821,1067,552,552,0,552,469,83,1067,1067,0,0,1067,1033,895,127,0,1,0,10,34,32,2,0,0,0,1067,14,1053,1067,482,585,895,42,800
42,21,900,866420,721,368,368,0,368,333,35,721,721,0,0,721,711,674,31,0,1,1,4,10,9,1,0,0,0,721,18,703,721,346,375,674,42,900
42,21,1000,2561330,1141,580,580,0,580,486,94,1141,1141,0,0,1141,1087,533,540,1,1,0,12,54,51,3,0,0,0,1141,22,1119,1141,518,623,533,42,1000
42,21,1100,583485,439,300,300,0,300,248,52,439,439,0,0,439,434,416,16,0,2,0,0,5,5,0,0,0,0,439,5,434,439,211,228,416,42,1100
42,21,1200,1093389,3544,1815,1815,0,1815,1606,209,3544,3544,0,0,3544,3507,3415,74,2,9,0,7,37,35,2,0,0,0,3544,39,3505,3544,1594,1950,3415,42,1200
42,21,1300,1248166,2534,1295,1295,0,1295,1193,102,2534,2534,0,0,2534,2483,2154,306,4,4,0,15,51,44,4,3,0,0,2534,33,2501,2534,1134,1400,2154,42,1300
42,21,1400,609627,921,461,461,0,461,417,44,921,921,0,0,921,907,771,122,4,0,1,9,14,14,0,0,0,0,921,22,899,921,428,493,771,42,1400
42,21,10100,50877757,4380,1851,1851,0,1851,1764,87,4380,4380,0,0,4380,4365,4265,92,3,2,0,3,15,14,1,0,0,0,4380,39,4341,4380,2147,2233,4265,42,10100
42,21,10200,2162013,1733,907,907,0,907,792,115,1733,1733,0,0,1733,1723,1638,83,0,0,2,0,10,10,0,0,0,0,1733,16,1717,1733,805,928,1638,42,10200
42,21,10300,29983875,2501,1034,1034,0,1034,995,39,2501,2501,0,0,2501,2494,2469,20,1,4,0,0,7,7,0,0,0,0,2501,15,2486,2501,1212,1289,2469,42,10300
42,21,10400,457107,1503,745,745,0,745,685,60,1503,1503,0,0,1503,1483,1401,69,4,4,0,5,20,18,2,0,0,0,1503,22,1481,1503,681,822,1401,42,10400
42,21,10500,9618698,3951,1964,1964,0,1964,1832,132,3951,3951,0,0,3951,3934,3883,33,0,11,0,7,17,17,0,0,0,0,3951,26,3925,3951,1849,2102,3883,42,10500
42,21,10600,2799171,2555,1160,1160,0,1160,1105,55,2555,2555,0,0,2555,2543,2496,10,1,35,0,1,12,12,0,0,0,0,2555,8,2547,2555,1189,1366,2496,42,10600
42,21,10700,22939324,3054,1309,1309,0,1309,1249,60,3054,3054,0,0,3054,3046,3020,6,4,16,0,0,8,8,0,0,0,0,3054,13,3041,3054,1480,1574,3020,42,10700
42,21,10801,15052010,5753,2555,2555,0,2555,2442,113,5753,5753,0,0,5753,5723,5575,37,5,97,0,9,30,28,2,0,0,0,5753,32,5721,5753,2638,3115,5575,42,10801
42,21,10802,13702881,3791,1130,1130,0,1130,1050,80,3791,3791,0,0,3791,3773,3641,55,3,67,0,7,18,18,0,0,0,0,3791,20,3771,3791,1693,2098,3641,42,10802
42,21,10900,1610566,851,375,375,0,375,347,28,851,851,0,0,851,849,847,2,0,0,0,0,2,2,0,0,0,0,851,5,846,851,399,452,847,42,10900
42,21,11000,913792,1834,849,849,0,849,792,57,1834,1834,0,0,1834,1830,1806,21,2,1,0,0,4,3,1,0,0,0,1834,4,1830,1834,861,973,1806,42,11000
42,21,11100,30756842,5862,2275,2275,0,2275,2156,119,5862,5862,0,0,5862,5848,5764,39,9,29,3,4,14,14,0,0,0,0,5862,22,5840,5862,2738,3124,5764,42,11100
42,21,11200,2723517,2262,1021,1021,0,1021,965,56,2262,2262,0,0,2262,2242,2223,5,1,10,0,3,20,20,0,0,0,0,2262,11,2251,2262,1067,1195,2223,42,11200
42,21,11300,6139328,5523,2376,2376,0,2376,2238,138,5523,5523,0,0,5523,5493,5390,17,5,71,3,7,30,24,6,0,0,0,5523,50,5473,5523,2603,2920,5390,42,11300
42,21,11400,34803850,3912,1880,1880,0,1880,1772,108,3912,3912,0,0,3912,3899,3857,27,0,11,2,2,13,12,1,0,0,0,3912,12,3900,3912,1839,2073,3857,42,11400
42,21,11500,125167032,4925,2025,2025,0,2025,1940,85,4925,4925,0,0,4925,4900,4891,2,1,4,0,2,25,24,1,0,0,0,4925,5,4920,4925,2433,2492,4891,42,11500
42,21,11600,4736116,3054,1362,1362,0,1362,1272,90,3054,3054,0,0,3054,3045,3036,7,1,0,0,1,9,8,1,0,0,0,3054,9,3045,3054,1427,1627,3036,42,11600
42,21,11700,81783662,2728,1128,1128,0,1128,1043,85,2728,2728,0,0,2728,2722,2719,1,0,1,0,1,6,6,0,0,0,0,2728,6,2722,2728,1387,1341,2719,42,11700
42,21,11800,153404836,4373,1701,1701,0,1701,1582,119,4373,4373,0,0,4373,4367,4359,1,5,1,0,1,6,6,0,0,0,0,4373,13,4360,4373,2181,2192,4359,42,11800
42,21,11900,7757841,4199,1954,1954,0,1954,1763,191,4199,4199,0,0,4199,4192,4170,3,4,10,1,4,7,7,0,0,0,0,4199,13,4186,4199,1987,2212,4170,42,11900
42,21,12000,193711488,6437,2751,2751,0,2751,2508,243,6437,6437,0,0,6437,6423,6406,5,4,3,0,5,14,14,0,0,0,0,6437,20,6417,6437,3140,3297,6406,42,12000
42,21,12100,153287654,2577,1216,1216,0,1216,934,282,2577,2577,0,0,2577,2563,2529,10,2,16,2,4,14,14,0,0,0,0,2577,9,2568,2577,1322,1255,2529,42,12100
42,21,12200,100381629,4044,1686,1686,0,1686,1570,116,4044,4044,0,0,4044,4017,4006,2,6,1,1,1,27,27,0,0,0,0,4044,19,4025,4044,1996,2048,4006,42,12200
42,21,12300,79721510,3798,777,777,0,777,716,61,3798,3798,0,0,3798,3776,3301,430,7,33,1,4,22,22,0,0,0,0,3798,273,3525,3798,2259,1539,3301,42,12300
42,21,12400,94852026,4292,1674,1674,0,1674,1573,101,4292,4292,0,0,4292,4277,4269,4,0,2,0,2,15,15,0,0,0,0,4292,2,4290,4292,2141,2151,4269,42,12400
42,21,12500,127574248,6323,2105,2105,0,2105,2015,90,6323,6323,0,0,6323,6297,6069,189,7,23,4,5,26,24,2,0,0,0,6323,35,6288,6323,3237,3086,6069,42,12500
42,21,12600,4408369,3091,1474,1474,0,1474,1357,117,3091,3091,0,0,3091,3081,3050,11,0,16,0,4,10,10,0,0,0,0,3091,16,3075,3091,1461,1630,3050,42,12600
42,21,12700,71549635,2680,1106,1106,0,1106,1039,67,2680,2680,0,0,2680,2670,2665,1,2,1,1,0,10,4,0,0,0,6,2680,7,2673,2680,1313,1367,2665,42,12700
42,21,12800,32637698,6366,2180,2180,0,2180,2019,161,6366,6366,0,0,6366,6339,5629,560,8,18,0,124,27,24,0,0,0,3,6366,155,6211,6366,3634,2732,5629,42,12800
42,21,12900,62993048,3906,1552,1552,0,1552,1458,94,3906,3906,0,0,3906,3890,3871,8,1,6,0,4,16,13,3,0,0,0,3906,14,3892,3906,1937,1969,3871,42,12900
42,21,13000,1723735,2837,1367,1367,0,1367,1232,135,2837,2837,0,0,2837,2828,2822,2,1,2,0,1,9,9,0,0,0,0,2837,14,2823,2837,1319,1518,2822,42,13000
42,21,13100,75653924,2976,1193,1193,0,1193,1098,95,2976,2976,0,0,2976,2967,2964,2,1,0,0,0,9,9,0,0,0,0,2976,1,2975,2976,1466,1510,2964,42,13100
42,21,13200,50480465,4126,1670,1670,0,1670,1573,97,4126,4126,0,0,4126,4115,4102,4,1,2,0,6,11,10,1,0,0,0,4126,17,4109,4126,2048,2078,4102,42,13200
42,21,13300,120492598,6495,2642,2642,0,2642,2521,121,6495,6495,0,0,6495,6461,6423,3,12,8,5,10,34,28,4,2,0,0,6495,49,6446,6495,3183,3312,6423,42,13300
42,23,960100,1890716,2526,1215,1215,0,1215,1089,126,2526,2526,0,0,2526,2514,2485,18,3,2,3,3,12,11,1,0,0,0,2526,23,2503,2526,1181,1345,2485,42,960100
42,23,960200,1026760011,3448,3377,3377,0,3377,1376,2001,3448,3448,0,0,3448,3432,3419,3,5,5,0,0,16,13,3,0,0,0,3448,11,3437,3448,1754,1694,3419,42,960200
42,25,20101,373994746,6914,7149,7149,0,7149,2673,4476,6914,6914,0,0,6914,6769,6419,211,19,31,5,84,145,133,12,0,0,0,6914,349,6565,6914,3495,3419,6419,42,20101
42,25,20102,37465580,4804,2193,2193,0,2193,1967,226,4804,4804,0,0,4804,4774,4725,30,2,13,2,2,30,28,2,0,0,0,4804,40,4764,4804,2346,2458,4725,42,20102
42,25,20200,194460283,6670,2864,2864,0,2864,2558,306,6670,6670,0,0,6670,6641,6593,12,15,8,3,10,29,27,2,0,0,0,6670,46,6624,6670,3183,3487,6593,42,20200
42,25,20300,77900534,6262,3050,3050,0,3050,2646,404,6262,6262,0,0,6262,6221,6156,23,11,19,0,12,41,39,2,0,0,0,6262,62,6200,6262,3066,3196,6156,42,20300
42,25,20400,4042633,4230,2228,2228,0,2228,1878,350,4230,4230,0,0,4230,4199,4153,15,3,13,3,12,31,25,6,0,0,0,4230,60,4170,4230,1932,2298,4153,42,20400
42,25,20500,119208021,6439,2689,2689,0,2689,2490,199,6439,6439,0,0,6439,6411,6341,14,19,23,0,14,28,28,0,0,0,0,6439,33,6406,6439,3170,3269,6341,42,20500
42,25,20600,4438746,5537,2546,2546,0,2546,2362,184,5537,5537,0,0,5537,5498,5444,19,3,25,5,2,39,36,3,0,0,0,5537,37,5500,5537,2578,2959,5444,42,20600
42,25,20700,42278234,5155,2237,2237,0,2237,2036,201,5155,5155,0,0,5155,5130,5080,6,8,30,0,6,25,23,2,0,0,0,5155,23,5132,5155,2604,2551,5080,42,20700
42,25,20800,126647942,7543,3171,3171,0,3171,2871,300,7543,7543,0,0,7543,7505,7451,15,7,12,0,20,38,36,2,0,0,0,7543,84,7459,7543,3760,3783,7451,42,20800
42,25,20900,6444629,5248,2365,2365,0,2365,2220,145,5248,5248,0,0,5248,5210,5158,8,9,9,2,24,38,36,2,0,0,0,5248,124,5124,5248,2499,2749,5158,42,20900
42,27,10100,219483412,4004,1834,1834,0,1834,1552,282,4004,4004,0,0,4004,3990,3973,5,9,1,0,2,14,14,0,0,0,0,4004,14,3990,4004,2025,1979,3973,42,10100
42,27,10200,437426452,2941,1488,1488,0,1488,1124,364,2941,2941,0,0,2941,2935,2925,0,4,3,3,0,6,6,0,0,0,0,2941,12,2929,2941,1519,1422,2925,42,10200
42,27,10300,2800940,3494,1710,1710,0,1710,1550,160,3494,3494,0,0,3494,3473,3442,10,5,12,0,4,21,21,0,0,0,0,3494,8,3486,3494,1609,1885,3442,42,10300
42,27,10400,385007172,3466,1687,1687,0,1687,1359,328,3466,3466,0,0,3466,3456,3441,0,6,9,0,0,10,9,1,0,0,0,3466,8,3458,3466,1672,1794,3441,42,10400
42,27,10500,324689485,5038,2137,2137,0,2137,1929,208,5038,5038,0,0,5038,5009,4955,9,6,11,4,24,29,23,6,0,0,0,5038,47,4991,5038,2562,2476,4955,42,10500
42,27,10600,144122935,4021,1644,1644,0,1644,1522,122,4021,4021,0,0,4021,4005,3974,7,19,1,0,4,16,16,0,0,0,0,4021,21,4000,4021,1985,2036,3974,42,10600
42,27,10700,161765402,4277,1596,1596,0,1596,1527,69,4277,4277,0,0,4277,4259,4240,4,4,7,0,4,18,18,0,0,0,0,4277,14,4263,4277,2158,2119,4240,42,10700
42,27,10800,388498605,4845,2228,2228,0,2228,1725,503,4845,4845,0,0,4845,4831,4784,19,4,21,1,2,14,12,2,0,0,0,4845,18,4827,4845,2382,2463,4784,42,10800
42,27,10900,269898369,6537,2908,2908,0,2908,2543,365,6537,6537,0,0,6537,6523,6474,15,9,11,6,8,14,14,0,0,0,0,6537,24,6513,6537,3272,3265,6474,42,10900
42,27,11000,66948706,6117,2559,2559,0,2559,2456,103,6117,6117,0,0,6117,6074,6030,15,4,10,6,9,43,42,1,0,0,0,6117,28,6089,6117,2954,3163,6030,42,11000
42,27,11100,4718722,6395,2953,2953,0,2953,2796,157,6395,6395,0,0,6395,6343,6219,58,7,30,7,22,52,50,1,0,1,0,6395,38,6357,6395,2952,3443,6219,42,11100
42,27,11200,73851527,5217,1386,1386,0,1386,1324,62,5217,5217,0,0,5217,5193,3970,1035,12,24,3,149,24,23,1,0,0,0,5217,183,5034,5217,3597,1620,3970,42,11200
42,27,11300,39571485,6106,2895,2895,0,2895,2775,120,6106,6106,0,0,6106,5998,5267,323,12,328,2,66,108,102,5,1,0,0,6106,154,5952,6106,3232,2874,5267,42,11300
42,27,11400,24713059,5314,2079,2079,0,2079,2016,63,5314,5314,0,0,5314,5224,4924,82,3,184,5,26,90,80,10,0,0,0,5314,93,5221,5314,2651,2663,4924,42,11400
42,27,11500,11373409,8914,3698,3698,0,3698,3592,106,8914,8914,0,0,8914,8726,7410,306,9,931,4,66,188,173,15,0,0,0,8914,226,8688,8914,4589,4325,7410,42,11500
42,27,11600,18744359,3694,1072,1072,0,1072,1043,29,3694,3694,0,0,3694,3665,3450,75,0,119,0,21,29,28,1,0,0,0,3694,39,3655,3694,1779,1915,3450,42,11600
42,27,11700,28681840,4795,2141,2141,0,2141,2026,115,4795,4795,0,0,4795,4765,4550,64,4,109,0,38,30,30,0,0,0,0,4795,61,4734,4795,2283,2512,4550,42,11700
42,27,11800,82689613,4657,1855,1855,0,1855,1752,103,4657,4657,0,0,4657,4592,4437,61,3,76,3,12,65,62,1,0,2,0,4657,54,4603,4657,2274,2383,4437,42,11800
42,27,11901,58626392,2357,802,802,0,802,769,33,2357,2357,0,0,2357,2339,2328,7,0,3,0,1,18,18,0,0,0,0,2357,12,2345,2357,1244,1113,2328,42,11901
42,27,11902,113122571,5149,2001,2001,0,2001,1919,82,5149,5149,0,0,5149,5118,4949,32,6,115,0,16,31,30,1,0,0,0,5149,30,5119,5149,2572,2577,4949,42,11902
42,27,12000,1405829,6090,2421,2421,0,2421,2287,134,6090,6090,0,0,6090,6004,5501,129,4,305,7,58,86,86,0,0,0,0,6090,143,5947,6090,3475,2615,5501,42,12000
42,27,12100,930549,6378,458,458,0,458,448,10,6378,6378,0,0,6378,6234,4814,496,11,757,20,136,144,136,7,1,0,0,6378,271,6107,6378,2421,3957,4814,42,12100
42,27,12200,1476298,5412,98,98,0,98,61,37,5412,5412,0,0,5412,5324,4490,276,13,381,14,150,88,82,6,0,0,0,5412,240,5172,5412,3250,2162,4490,42,12200
42,27,12300,1387383,1822,819,819,0,819,788,31,1822,1822,0,0,1822,1789,1685,39,2,51,0,12,33,33,0,0,0,0,1822,46,1776,1822,939,883,1685,42,12300
42,27,12400,1242899,4287,2005,2005,0,2005,1934,71,4287,4287,0,0,4287,4230,3611,83,5,488,1,42,57,54,1,0,2,0,4287,94,4193,4287,2482,1805,3611,42,12400
42,27,12500,346239,3548,1630,1630,0,1630,1581,49,3548,3548,0,0,3548,3510,3185,48,4,223,1,49,38,38,0,0,0,0,3548,86,3462,3548,1830,1718,3185,42,12500
42,27,12600,543012,3240,1430,1430,0,1430,1393,37,3240,3240,0,0,3240,3175,2780,56,4,306,5,24,65,55,9,1,0,0,3240,82,3158,3240,1786,1454,2780,42,12600
42,27,12700,2681901,2716,1265,1265,0,1265,1231,34,2716,2716,0,0,2716,2681,2524,68,5,73,1,10,35,34,0,1,0,0,2716,52,2664,2716,1351,1365,2524,42,12700
42,27,12800,1749003,4927,2362,2362,0,2362,2301,61,4927,4927,0,0,4927,4867,3802,222,10,784,1,48,60,55,4,0,1,0,4927,145,4782,4927,2477,2450,3802,42,12800
42,29,300101,6503124,2911,1279,1279,0,1279,1243,36,2911,2911,0,0,2911,2894,2736,18,4,134,0,2,17,15,2,0,0,0,2911,31,2880,2911,1415,1496,2736,42,300101
42,29,300103,2119924,2545,1212,1212,0,1212,1163,49,2545,2545,0,0,2545,2527,2179,220,3,108,0,17,18,17,1,0,0,0,2545,31,2514,2545,1168,1377,2179,42,300103
42,29,300104,6546721,5018,2060,2060,0,2060,1998,62,5018,5018,0,0,5018,4988,4705,121,4,137,2,19,30,28,2,0,0,0,5018,55,4963,5018,2388,2630,4705,42,300104
42,29,300106,4171276,4625,2413,2413,0,2413,2356,57,4625,4625,0,0,4625,4593,4149,85,8,327,0,24,32,30,2,0,0,0,4625,94,4531,4625,2065,2560,4149,42,300106
42,29,300107,20499571,4299,1484,1484,0,1484,1452,32,4299,4299,0,0,4299,4269,4044,54,5,163,1,2,30,29,1,0,0,0,4299,24,4275,4299,2109,2190,4044,42,300107
42,29,300108,6321165,6100,2807,2807,0,2807,2733,74,6100,6100,0,0,6100,6038,5304,161,8,546,1,18,62,57,5,0,0,0,6100,87,6013,6100,2907,3193,5304,42,300108
42,29,300109,5222228,3564,1296,1296,0,1296,1278,18,3564,3564,0,0,3564,3537,3295,166,1,72,0,3,27,26,1,0,0,0,3564,28,3536,3564,1708,1856,3295,42,300109
42,29,300201,6470772,5067,2035,2035,0,2035,1978,57,5067,5067,0,0,5067,5036,4675,229,8,121,0,3,31,25,6,0,0,0,5067,58,5009,5067,2395,2672,4675,42,300201
42,29,300202,14829389,5203,1827,1827,0,1827,1780,47,5203,5203,0,0,5203,5171,4955,29,3,165,1,18,32,32,0,0,0,0,5203,53,5150,5203,2554,2649,4955,42,300202
42,29,300301,29650023,3458,1443,1443,0,1443,1394,49,3458,3458,0,0,3458,3452,3261,93,3,71,0,24,6,6,0,0,0,0,3458,46,3412,3458,1643,1815,3261,42,300301
42,29,300302,14509813,3673,1233,1233,0,1233,1214,19,3673,3673,0,0,3673,3663,3581,50,0,21,9,2,10,10,0,0,0,0,3673,20,3653,3673,1800,1873,3581,42,300302
42,29,300303,3064462,2880,1256,1256,0,1256,1198,58,2880,2880,0,0,2880,2867,2754,71,2,35,1,4,13,12,1,0,0,0,2880,15,2865,2880,1398,1482,2754,42,300303
42,29,300400,3240936,3059,1419,1419,0,1419,1361,58,3059,3059,0,0,3059,3017,2787,117,6,99,0,8,42,41,1,0,0,0,3059,47,3012,3059,1474,1585,2787,42,300400
42,29,300500,22193788,6960,2652,2652,0,2652,2536,116,6960,6960,0,0,6960,6921,6600,116,5,173,2,25,39,35,4,0,0,0,6960,88,6872,6960,3488,3472,6600,42,300500
42,29,300600,4245584,3497,1500,1500,0,1500,1422,78,3497,3497,0,0,3497,3432,2842,500,2,59,0,29,65,60,5,0,0,0,3497,85,3412,3497,1712,1785,2842,42,300600
42,29,300700,1304982,4604,2202,2202,0,2202,2045,157,4604,4604,0,0,4604,4508,3945,380,12,73,0,98,96,82,13,0,1,0,4604,211,4393,4604,2189,2415,3945,42,300700
42,29,300800,1980919,4208,2064,2064,0,2064,1994,70,4208,4208,0,0,4208,4148,3735,207,4,171,2,29,60,54,5,1,0,0,4208,101,4107,4208,2031,2177,3735,42,300800
42,29,300900,1764812,2479,1027,1027,0,1027,999,28,2479,2479,0,0,2479,2458,2335,46,4,55,1,17,21,20,1,0,0,0,2479,35,2444,2479,1207,1272,2335,42,300900
42,29,301000,22770675,6551,2604,2604,0,2604,2530,74,6551,6551,0,0,6551,6525,6306,89,5,113,2,10,26,23,3,0,0,0,6551,45,6506,6551,3167,3384,6306,42,301000
42,29,301100,1980588,3305,1508,1508,0,1508,1412,96,3305,3305,0,0,3305,3274,3148,64,17,34,2,9,31,28,3,0,0,0,3305,39,3266,3305,1673,1632,3148,42,301100
42,29,301201,2978056,295,0,0,0,0,0,0,295,295,0,0,295,293,268,25,0,0,0,0,2,1,1,0,0,0,295,1,294,295,266,29,268,42,301201
42,29,301202,32069321,5198,1960,1960,0,1960,1888,72,5198,5198,0,0,5198,5132,4818,234,5,51,2,22,66,65,1,0,0,0,5198,60,5138,5198,2547,2651,4818,42,301202
42,29,301300,27930794,4566,1684,1684,0,1684,1649,35,4566,4566,0,0,4566,4554,4492,39,5,10,0,8,12,9,2,1,0,0,4566,32,4534,4566,2176,2390,4492,42,301300
42,29,301401,5820265,2705,1276,1276,0,1276,1221,55,2705,2705,0,0,2705,2675,2576,63,4,27,0,5,30,29,1,0,0,0,2705,22,2683,2705,1342,1363,2576,42,301401
42,29,301402,28890195,4676,1838,1838,0,1838,1791,47,4676,4676,0,0,4676,4654,4524,69,11,34,0,16,22,21,1,0,0,0,4676,45,4631,4676,2318,2358,4524,42,301402
42,29,301500,19356851,1895,721,721,0,721,690,31,1895,1895,0,0,1895,1887,1866,12,3,2,0,4,8,7,1,0,0,0,1895,13,1882,1895,940,955,1866,42,301500
42,29,301600,49684713,2556,1033,1033,0,1033,999,34,2556,2556,0,0,2556,2542,2509,6,7,12,0,8,14,14,0,0,0,0,2556,17,2539,2556,1311,1245,2509,42,301600
42,29,301700,42439597,1787,587,587,0,587,569,18,1787,1787,0,0,1787,1779,1749,18,0,5,1,6,8,8,0,0,0,0,1787,13,1774,1787,906,881,1749,42,301700
42,29,301800,45968401,3170,1121,1121,0,1121,1077,44,3170,3170,0,0,3170,3147,3100,19,4,21,1,2,23,19,2,0,2,0,3170,18,3152,3170,1601,1569,3100,42,301800
42,29,301900,25811437,3551,1240,1240,0,1240,1214,26,3551,3551,0,0,3551,3538,3413,44,1,67,0,13,13,13,0,0,0,0,3551,36,3515,3551,1757,1794,3413,42,301900
42,29,302000,32449603,4051,1397,1397,0,1397,1340,57,4051,4051,0,0,4051,4013,3863,63,7,69,1,10,38,33,5,0,0,0,4051,56,3995,4051,1974,2077,3863,42,302000
42,29,302101,22004980,5360,1947,1947,0,1947,1893,54,5360,5360,0,0,5360,5292,4814,145,6,283,2,42,68,65,3,0,0,0,5360,144,5216,5360,2609,2751,4814,42,302101
42,29,302102,6481136,3973,1513,1513,0,1513,1361,152,3973,3973,0,0,3973,3919,3546,161,2,182,2,26,54,48,6,0,0,0,3973,82,3891,3973,1654,2319,3546,42,302102
42,29,302202,19634172,6109,2839,2839,0,2839,2754,85,6109,6109,0,0,6109,6043,5452,231,16,308,1,35,66,62,3,0,0,1,6109,101,6008,6109,2943,3166,5452,42,302202
42,29,302203,7103102,4472,1549,1549,0,1549,1540,9,4472,4472,0,0,4472,4436,4041,262,8,95,4,26,36,35,1,0,0,0,4472,83,4389,4472,2190,2282,4041,42,302203
42,29,302204,6829736,5918,2360,2360,0,2360,2324,36,5918,5918,0,0,5918,5864,5249,394,2,195,5,19,54,49,4,0,1,0,5918,146,5772,5918,2941,2977,5249,42,302204
42,29,302300,1021392,2617,1285,1285,0,1285,1227,58,2617,2617,0,0,2617,2582,2286,199,8,69,1,19,35,32,3,0,0,0,2617,61,2556,2617,1227,1390,2286,42,302300
42,29,302400,1282223,3954,1704,1704,0,1704,1632,72,3954,3954,0,0,3954,3850,2340,1085,16,64,6,339,104,101,3,0,0,0,3954,738,3216,3954,2008,1946,2340,42,302400
42,29,302500,1144166,3880,1881,1881,0,1881,1796,85,3880,3880,0,0,3880,3827,3444,260,14,46,6,57,53,50,3,0,0,0,3880,149,3731,3880,1915,1965,3444,42,302500
42,29,302600,1082026,4489,1671,1671,0,1671,1610,61,4489,4489,0,0,4489,4368,2925,1150,13,49,0,231,121,114,7,0,0,0,4489,576,3913,4489,2172,2317,2925,42,302600
42,29,302701,10018218,7601,2878,2878,0,2878,2826,52,7601,7601,0,0,7601,7543,6958,291,3,253,1,37,58,55,3,0,0,0,7601,113,7488,7601,3735,3866,6958,42,302701
42,29,302702,4446054,4683,2091,2091,0,2091,2038,53,4683,4683,0,0,4683,4632,3837,412,5,313,1,64,51,50,1,0,0,0,4683,174,4509,4683,2331,2352,3837,42,302702
42,29,302703,11316627,3698,1248,1248,0,1248,1232,16,3698,3698,0,0,3698,3679,3505,88,1,75,0,10,19,19,0,0,0,0,3698,47,3651,3698,1839,1859,3505,42,302703
42,29,302704,5088183,4513,1486,1486,0,1486,1458,28,4513,4513,0,0,4513,4486,4249,80,0,134,0,23,27,27,0,0,0,0,4513,76,4437,4513,2199,2314,4249,42,302704
42,29,302802,10298630,4314,1461,1461,0,1461,1436,25,4314,4314,0,0,4314,4284,4179,44,2,58,0,1,30,28,2,0,0,0,4314,27,4287,4314,2120,2194,4179,42,302802
42,29,302803,2906841,2269,1407,1407,0,1407,1332,75,2269,2269,0,0,2269,2267,2252,8,1,6,0,0,2,2,0,0,0,0,2269,7,2262,2269,919,1350,2252,42,302803
42,29,302804,7309059,3711,1466,1466,0,1466,1426,40,3711,3711,0,0,3711,3698,3527,63,3,97,3,5,13,13,0,0,0,0,3711,39,3672,3711,1786,1925,3527,42,302804
42,29,302805,5727657,6530,3162,3162,0,3162,2971,191,6530,6530,0,0,6530,6475,5922,337,3,170,3,40,55,50,5,0,0,0,6530,124,6406,6530,3189,3341,5922,42,302805
42,29,302901,10283294,4508,1772,1772,0,1772,1715,57,4508,4508,0,0,4508,4483,4215,125,5,121,1,16,25,23,2,0,0,0,4508,50,4458,4508,2155,2353,4215,42,302901
42,29,302902,12333771,5844,2023,2023,0,2023,1990,33,5844,5844,0,0,5844,5810,5513,143,2,130,0,22,34,31,2,1,0,0,5844,67,5777,5844,2916,2928,5513,42,302902
42,29,303000,10128792,2678,1095,1095,0,1095,1023,72,2678,2678,0,0,2678,2659,2461,69,0,122,1,6,19,14,4,1,0,0,2678,21,2657,2678,1309,1369,2461,42,303000
42,29,303100,16581939,4221,1413,1413,0,1413,1391,22,4221,4221,0,0,4221,4197,3984,24,2,172,2,13,24,24,0,0,0,0,4221,50,4171,4221,2089,2132,3984,42,303100
42,29,303200,24944018,2850,1068,1068,0,1068,1030,38,2850,2850,0,0,2850,2822,2717,21,4,73,0,7,28,28,0,0,0,0,2850,50,2800,2850,1434,1416,2717,42,303200
42,29,303300,40271065,6451,2526,2526,0,2526,2457,69,6451,6451,0,0,6451,6388,5982,133,2,91,2,178,63,58,5,0,0,0,6451,593,5858,6451,3202,3249,5982,42,303300
42,29,303401,1804178,3327,1196,1196,0,1196,1152,44,3327,3327,0,0,3327,3254,2492,291,3,32,0,436,73,71,2,0,0,0,3327,1011,2316,3327,1694,1633,2492,42,303401
42,29,303402,1114478,1946,771,771,0,771,716,55,1946,1946,0,0,1946,1916,1388,250,2,54,0,222,30,30,0,0,0,0,1946,459,1487,1946,924,1022,1388,42,303402
42,29,303500,40450689,6317,2188,2188,0,2188,2131,57,6317,6317,0,0,6317,6246,5963,76,6,147,4,50,71,68,3,0,0,0,6317,250,6067,6317,3166,3151,5963,42,303500
42,29,303600,20600206,2384,878,878,0,878,847,31,2384,2384,0,0,2384,2372,2326,19,0,22,5,0,12,12,0,0,0,0,2384,17,2367,2384,1187,1197,2326,42,303600
42,29,303700,31020436,1150,446,446,0,446,429,17,1150,1150,0,0,1150,1140,1116,9,0,5,2,8,10,8,2,0,0,0,1150,23,1127,1150,581,569,1116,42,303700
42,29,303801,24497421,3935,1306,1306,0,1306,1285,21,3935,3935,0,0,3935,3874,3418,375,27,18,0,36,61,54,7,0,0,0,3935,129,3806,3935,2127,1808,3418,42,303801
42,29,303802,23576650,6840,2158,2158,0,2158,2134,24,6840,6840,0,0,6840,6773,6539,157,7,49,1,20,67,62,1,4,0,0,6840,61,6779,6840,3402,3438,6539,42,303802
42,29,303900,38936355,9405,3150,3150,0,3150,3076,74,9405,9405,0,0,9405,9352,8789,328,16,176,5,38,53,50,3,0,0,0,9405,132,9273,9405,4506,4899,8789,42,303900
42,29,304000,9407219,2857,1276,1276,0,1276,1205,71,2857,2857,0,0,2857,2814,2507,176,10,115,1,5,43,41,2,0,0,0,2857,54,2803,2857,1429,1428,2507,42,304000
42,29,304101,3483020,3989,1851,1851,0,1851,1768,83,3989,3989,0,0,3989,3920,3343,376,3,137,3,58,69,60,9,0,0,0,3989,136,3853,3989,1926,2063,3343,42,304101
42,29,304102,2176134,3600,1346,1346,0,1346,1291,55,3600,3600,0,0,3600,3542,3005,443,6,37,0,51,58,49,9,0,0,0,3600,132,3468,3600,1666,1934,3005,42,304102
42,29,304201,11573376,6413,2432,2432,0,2432,2336,96,6413,6413,0,0,6413,6301,5255,700,16,227,6,97,112,95,15,2,0,0,6413,238,6175,6413,3134,3279,5255,42,304201
42,29,304202,10352608,4955,2087,2087,0,2087,2012,75,4955,4955,0,0,4955,4882,3753,1016,4,64,0,45,73,58,14,1,0,0,4955,142,4813,4955,2389,2566,3753,42,304202
42,29,304300,29492346,5822,2035,2035,0,2035,2003,32,5822,5822,0,0,5822,5776,5625,73,6,67,1,4,46,43,3,0,0,0,5822,30,5792,5822,2886,2936,5625,42,304300
42,29,304402,17708231,7802,2454,2454,0,2454,2427,27,7802,7802,0,0,7802,7757,7414,89,5,232,0,17,45,42,3,0,0,0,7802,78,7724,7802,3860,3942,7414,42,304402
42,29,304403,4792108,3893,1508,1508,0,1508,1480,28,3893,3893,0,0,3893,3848,3594,111,4,120,0,19,45,41,4,0,0,0,3893,66,3827,3893,1854,2039,3594,42,304403
42,29,304404,4549705,4881,2068,2068,0,2068,2014,54,4881,4881,0,0,4881,4829,4518,106,4,185,1,15,52,50,1,0,1,0,4881,61,4820,4881,2427,2454,4518,42,304404
42,29,304500,27843747,6850,2167,2167,0,2167,2132,35,6850,6850,0,0,6850,6815,6672,48,4,77,0,14,35,35,0,0,0,0,6850,66,6784,6850,3427,3423,6672,42,304500
42,29,304600,31163269,3240,1045,1045,0,1045,1009,36,3240,3240,0,0,3240,3233,3100,81,1,38,2,11,7,7,0,0,0,0,3240,42,3198,3240,1667,1573,3100,42,304600
42,29,304700,34753425,2031,745,745,0,745,715,30,2031,2031,0,0,2031,2007,1981,15,0,6,0,5,24,24,0,0,0,0,2031,17,2014,2031,1037,994,1981,42,304700
42,29,304800,2584088,959,460,460,0,460,412,48,959,959,0,0,959,951,931,3,0,13,0,4,8,8,0,0,0,0,959,6,953,959,445,514,931,42,304800
42,29,304900,65030610,6278,2134,2134,0,2134,2054,80,6278,6278,0,0,6278,6230,6115,68,15,12,2,18,48,46,0,2,0,0,6278,62,6216,6278,2986,3292,6115,42,304900
42,29,305000,1273845,1287,500,500,0,500,474,26,1287,1287,0,0,1287,1276,1261,3,3,1,0,8,11,10,1,0,0,0,1287,13,1274,1287,614,673,1261,42,305000
42,29,305100,56328185,7054,2458,2458,0,2458,2406,52,7054,7054,0,0,7054,6997,6740,185,12,25,3,32,57,55,2,0,0,0,7054,69,6985,7054,3610,3444,6740,42,305100
42,29,305200,34085247,7074,2580,2580,0,2580,2522,58,7074,7074,0,0,7074,7036,6745,234,10,28,0,19,38,33,5,0,0,0,7074,50,7024,7074,3488,3586,6745,42,305200
42,29,305300,15459830,5116,1974,1974,0,1974,1874,100,5116,5116,0,0,5116,5029,3663,1279,6,20,0,61,87,84,3,0,0,0,5116,183,4933,5116,2493,2623,3663,42,305300
42,29,305400,1350032,2366,947,947,0,947,868,79,2366,2366,0,0,2366,2291,1303,878,4,14,1,91,75,70,5,0,0,0,2366,252,2114,2366,1080,1286,1303,42,305400
42,29,305500,1821109,3507,1511,1511,0,1511,1330,181,3507,3507,0,0,3507,3363,826,2369,11,11,1,145,144,139,5,0,0,0,3507,328,3179,3507,1610,1897,826,42,305500
42,29,305600,803789,2730,1057,1057,0,1057,933,124,2730,2730,0,0,2730,2628,887,1509,18,13,1,200,102,92,9,1,0,0,2730,432,2298,2730,1295,1435,887,42,305600
42,29,305700,824408,2235,845,845,0,845,809,36,2235,2235,0,0,2235,2185,1526,571,6,19,0,63,50,46,4,0,0,0,2235,153,2082,2235,1076,1159,1526,42,305700
42,29,305800,4405224,997,419,419,0,419,376,43,997,997,0,0,997,952,347,559,2,0,3,41,45,41,4,0,0,0,997,89,908,997,464,533,347,42,305800
42,29,305900,855200,610,211,211,0,211,200,11,610,610,0,0,610,585,461,110,3,0,0,11,25,15,10,0,0,0,610,71,539,610,298,312,461,42,305900
42,29,306000,40608947,5157,1860,1860,0,1860,1801,59,5157,5157,0,0,5157,5088,4558,471,7,22,6,24,69,67,2,0,0,0,5157,87,5070,5157,2591,2566,4558,42,306000
42,29,306100,44363279,859,375,375,0,375,349,26,859,859,0,0,859,858,807,11,2,5,3,30,1,1,0,0,0,0,859,74,785,859,440,419,807,42,306100
42,29,306200,44577614,5265,1698,1698,0,1698,1633,65,5265,5265,0,0,5265,5168,4812,127,12,23,0,194,97,89,8,0,0,0,5265,695,4570,5265,2750,2515,4812,42,306200
42,29,306300,1644167,2652,889,889,0,889,864,25,2652,2652,0,0,2652,2580,2088,222,11,0,0,259,72,71,1,0,0,0,2652,451,2201,2652,1298,1354,2088,42,306300
42,29,306400,1276135,1108,361,361,0,361,345,16,1108,1108,0,0,1108,1085,773,184,10,3,0,115,23,23,0,0,0,0,1108,422,686,1108,588,520,773,42,306400
42,29,306500,41789693,9083,2831,2831,0,2831,2700,131,9083,9083,0,0,9083,8937,7712,333,37,118,4,733,146,145,1,0,0,0,9083,2065,7018,9083,4940,4143,7712,42,306500
42,29,306600,25560074,2797,979,979,0,979,957,22,2797,2797,0,0,2797,2764,2700,25,1,26,1,11,33,25,8,0,0,0,2797,47,2750,2797,1421,1376,2700,42,306600
42,29,306700,34307102,3850,1237,1237,0,1237,1210,27,3850,3850,0,0,3850,3822,3724,43,7,29,0,19,28,28,0,0,0,0,3850,49,3801,3850,1917,1933,3724,42,306700
42,29,306800,26485262,1485,527,527,0,527,515,12,1485,1485,0,0,1485,1465,1439,12,0,2,0,12,20,14,6,0,0,0,1485,54,1431,1485,742,743,1439,42,306800
42,29,306900,30711771,4583,1390,1390,0,1390,1365,25,4583,4583,0,0,4583,4552,4431,44,4,30,2,41,31,31,0,0,0,0,4583,109,4474,4583,2280,2303,4431,42,306900
42,29,307000,24839144,2812,1093,1093,0,1093,1026,67,2812,2812,0,0,2812,2776,2622,75,5,9,0,65,36,36,0,0,0,0,2812,166,2646,2812,1389,1423,2622,42,307000
42,29,307100,29352838,1632,539,539,0,539,525,14,1632,1632,0,0,1632,1625,1559,20,0,9,0,37,7,6,1,0,0,0,1632,152,1480,1632,841,791,1559,42,307100
42,29,307200,44607567,1125,459,459,0,459,433,26,1125,1125,0,0,1125,1119,1049,55,0,5,0,10,6,4,2,0,0,0,1125,23,1102,1125,548,577,1049,42,307200
42,29,307300,16181976,2582,1025,1025,0,1025,946,79,2582,2582,0,0,2582,2564,2419,110,4,16,1,14,18,17,1,0,0,0,2582,21,2561,2582,1256,1326,2419,42,307300
42,29,307400,3227479,3373,1321,1321,0,1321,1243,78,3373,3373,0,0,3373,3348,3067,232,5,5,1,38,25,20,5,0,0,0,3373,127,3246,3373,1625,1748,3067,42,307400
42,29,307500,27631646,2444,818,818,0,818,802,16,2444,2444,0,0,2444,2429,2284,126,4,7,0,8,15,12,3,0,0,0,2444,19,2425,2444,1235,1209,2284,42,307500
42,29,307600,2288660,1217,429,429,0,429,413,16,1217,1217,0,0,1217,1205,1073,102,0,2,0,28,12,11,1,0,0,0,1217,60,1157,1217,592,625,1073,42,307600
42,29,307700,46792760,2485,858,858,0,858,829,29,2485,2485,0,0,2485,2462,2399,23,7,6,0,27,23,22,1,0,0,0,2485,57,2428,2485,1249,1236,2399,42,307700
42,29,307800,43486076,2095,743,743,0,743,725,18,2095,2095,0,0,2095,2064,1921,77,8,7,0,51,31,30,0,1,0,0,2095,56,2039,2095,1068,1027,1921,42,307800
42,29,307900,47154131,4319,1018,1018,0,1018,986,32,4319,4319,0,0,4319,4277,2648,1490,2,11,0,126,42,39,2,1,0,0,4319,282,4037,4319,2080,2239,2648,42,307900
42,29,308000,4956866,4315,1825,1825,0,1825,1703,122,4315,4315,0,0,4315,4227,3355,512,4,27,10,319,88,83,4,1,0,0,4315,697,3618,4315,1986,2329,3355,42,308000
42,29,308100,51885744,5516,1837,1837,0,1837,1759,78,5516,5516,0,0,5516,5445,5128,162,14,13,0,128,71,66,5,0,0,0,5516,292,5224,5516,2855,2661,5128,42,308100
42,29,308200,35916332,2634,1007,1007,0,1007,956,51,2634,2634,0,0,2634,2606,2494,51,10,7,0,44,28,27,1,0,0,0,2634,110,2524,2634,1317,1317,2494,42,308200
42,29,310200,1333254,627,46,46,0,46,45,1,627,627,0,0,627,622,457,162,3,0,0,0,5,5,0,0,0,0,627,6,621,627,544,83,457,42,310200
42,29,310400,237641,2921,0,0,0,0,0,0,2921,2921,0,0,2921,2877,2480,356,4,33,0,4,44,41,0,3,0,0,2921,72,2849,2921,1060,1861,2480,42,310400
42,29,310500,734513,650,370,370,0,370,357,13,650,650,0,0,650,650,642,4,0,4,0,0,0,0,0,0,0,0,650,4,646,650,193,457,642,42,310500
42,29,310900,855131,966,12,12,0,12,12,0,966,966,0,0,966,965,589,371,1,4,0,0,1,1,0,0,0,0,966,53,913,966,675,291,589,42,310900
42,31,990100,319498650,6216,4099,4099,0,4099,2625,1474,6216,6216,0,0,6216,6174,6089,65,5,11,0,4,42,39,3,0,0,0,6216,16,6200,6216,3094,3122,6089,42,990100
42,31,990200,177799325,3715,1917,1917,0,1917,1378,539,3715,3715,0,0,3715,3698,3678,8,7,4,0,1,17,17,0,0,0,0,3715,4,3711,3715,1876,1839,3678,42,990200
42,31,990300,193637021,4883,2045,2045,0,2045,1858,187,4883,4883,0,0,4883,4853,4798,12,1,37,2,3,30,30,0,0,0,0,4883,20,4863,4883,2393,2490,4798,42,990300
42,31,990400,130389579,3781,1712,1712,0,1712,1548,164,3781,3781,0,0,3781,3769,3755,0,10,4,0,0,12,12,0,0,0,0,3781,18,3763,3781,1841,1940,3755,42,990400
42,31,990500,211454440,4254,1903,1903,0,1903,1591,312,4254,4254,0,0,4254,4232,4203,3,7,9,0,10,22,21,0,0,1,0,4254,25,4229,4254,2105,2149,4203,42,990500
42,31,990600,3866752,6185,2192,2192,0,2192,2000,192,6185,6185,0,0,6185,6138,5848,215,5,61,0,9,47,46,1,0,0,0,6185,51,6134,6185,2611,3574,5848,42,990600
42,31,990700,152556582,4759,2172,2172,0,2172,1947,225,4759,4759,0,0,4759,4745,4732,8,4,1,0,0,14,14,0,0,0,0,4759,15,4744,4759,2299,2460,4732,42,990700
42,31,990800,192723293,4110,1826,1826,0,1826,1649,177,4110,4110,0,0,4110,4094,4070,8,6,6,0,4,16,16,0,0,0,0,4110,16,4094,4110,1972,2138,4070,42,990800
42,31,990900,178385565,3862,1560,1560,0,1560,1456,104,3862,3862,0,0,3862,3845,3825,10,0,9,0,1,17,17,0,0,0,0,3862,7,3855,3862,1971,1891,3825,42,990900
42,33,330100,57859253,5156,1990,1990,0,1990,1880,110,5156,5156,0,0,5156,5123,5096,7,2,17,1,0,33,33,0,0,0,0,5156,19,5137,5156,2380,2776,5096,42,330100
42,33,330200,2498631,3624,1734,1734,0,1734,1581,153,3624,3624,0,0,3624,3599,3559,11,5,18,1,5,25,25,0,0,0,0,3624,14,3610,3624,1701,1923,3559,42,330200
42,33,330300,6159790,4499,2222,2222,0,2222,2033,189,4499,4499,0,0,4499,4462,4416,13,3,25,3,2,37,37,0,0,0,0,4499,20,4479,4499,2083,2416,4416,42,330300
42,33,330400,76365362,6444,3056,3056,0,3056,2524,532,6444,6444,0,0,6444,6421,6337,16,5,53,2,8,23,23,0,0,0,0,6444,33,6411,6444,3222,3222,6337,42,330400
42,33,330500,344423873,4620,2372,2372,0,2372,1785,587,4620,4620,0,0,4620,4596,4590,0,3,2,1,0,24,24,0,0,0,0,4620,8,4612,4620,2328,2292,4590,42,330500
42,33,330600,149902250,3030,1332,1332,0,1332,1120,212,3030,3030,0,0,3030,3015,2977,25,10,1,0,2,15,14,1,0,0,0,3030,24,3006,3030,1476,1554,2977,42,330600
42,33,330700,519544536,2602,1617,1617,0,1617,912,705,2602,2602,0,0,2602,2571,2435,125,3,3,0,5,31,31,0,0,0,0,2602,33,2569,2602,1409,1193,2435,42,330700
42,33,330800,234510508,7030,3056,3056,0,3056,2743,313,7030,7030,0,0,7030,7005,6986,2,7,8,0,2,25,25,0,0,0,0,7030,30,7000,7030,3472,3558,6986,42,330800
42,33,330900,100929410,5141,2331,2331,0,2331,2131,200,5141,5141,0,0,5141,5117,5091,4,6,8,0,8,24,24,0,0,0,0,5141,30,5111,5141,2501,2640,5091,42,330900
42,33,331000,194858506,5501,2221,2221,0,2221,2073,148,5501,5501,0,0,5501,5480,5441,9,18,9,0,3,21,15,6,0,0,0,5501,8,5493,5501,2708,2793,5441,42,331000
42,33,331100,2795268,3448,1807,1807,0,1807,1660,147,3448,3448,0,0,3448,3429,3381,25,5,14,0,4,19,19,0,0,0,0,3448,13,3435,3448,1618,1830,3381,42,331100
42,33,331200,1910440,3183,1519,1519,0,1519,1410,109,3183,3183,0,0,3183,3177,3147,23,0,7,0,0,6,6,0,0,0,0,3183,9,3174,3183,1515,1668,3147,42,331200
42,33,331300,65358093,4682,2069,2069,0,2069,1950,119,4682,4682,0,0,4682,4663,4630,6,3,22,0,2,19,19,0,0,0,0,4682,11,4671,4682,2249,2433,4630,42,331300
42,33,331400,316438847,7301,3306,3306,0,3306,2917,389,7301,7301,0,0,7301,7281,7247,11,11,8,0,4,20,19,1,0,0,0,7301,19,7282,7301,3546,3755,7247,42,331400
42,33,331500,260471789,2061,1023,1023,0,1023,776,247,2061,2061,0,0,2061,2054,2047,0,2,2,1,2,7,7,0,0,0,0,2061,5,2056,2061,1045,1016,2047,42,331500
42,33,331600,198170712,2821,1351,1351,0,1351,1121,230,2821,2821,0,0,2821,2810,2803,2,1,1,0,3,11,11,0,0,0,0,2821,3,2818,2821,1399,1422,2803,42,331600
42,33,331700,114309864,6704,2314,2314,0,2314,2036,278,6704,6704,0,0,6704,6688,5545,956,9,12,1,165,16,15,1,0,0,0,6704,175,6529,6704,4165,2539,5545,42,331700
42,33,331800,96231638,2949,1361,1361,0,1361,1185,176,2949,2949,0,0,2949,2938,2929,1,2,5,0,1,11,11,0,0,0,0,2949,4,2945,2949,1445,1504,2929,42,331800
42,33,331900,228794926,2586,1174,1174,0,1174,948,226,2586,2586,0,0,2586,2571,2561,3,2,5,0,0,15,15,0,0,0,0,2586,13,2573,2586,1319,1267,2561,42,331900
42,35,970100,975139792,3582,3202,3202,0,3202,1576,1626,3582,3582,0,0,3582,3568,3553,4,7,2,1,1,14,14,0,0,0,0,3582,8,3574,3582,1753,1829,3553,42,970100
42,35,970200,359906624,5193,2548,2548,0,2548,2088,460,5193,5193,0,0,5193,5175,5129,11,8,18,2,7,18,18,0,0,0,0,5193,17,5176,5193,2568,2625,5129,42,970200
42,35,970300,433328147,3812,1995,1995,0,1995,1536,459,3812,3812,0,0,3812,3787,3761,3,4,16,1,2,25,25,0,0,0,0,3812,22,3790,3812,1850,1962,3761,42,970300
42,35,970400,38532756,4676,2031,2031,0,2031,1926,105,4676,4676,0,0,4676,4666,4635,13,1,12,2,3,10,10,0,0,0,0,4676,3,4673,4676,2287,2389,4635,42,970400
42,35,970500,78229678,4113,1717,1717,0,1717,1658,59,4113,4113,0,0,4113,4100,4058,22,1,16,0,3,13,12,1,0,0,0,4113,15,4098,4113,2063,2050,4058,42,970500
42,35,970600,2188187,1871,978,978,0,978,893,85,1871,1871,0,0,1871,1850,1810,15,5,10,1,9,21,21,0,0,0,0,1871,18,1853,1871,816,1055,1810,42,970600
42,35,970700,4314719,7278,2587,2587,0,2587,2413,174,7278,7278,0,0,7278,7217,6997,116,9,65,0,30,61,61,0,0,0,0,7278,84,7194,7278,3324,3954,6997,42,970700
42,35,970800,172620778,3869,1582,1582,0,1582,1460,122,3869,3869,0,0,3869,3852,3838,5,3,6,0,0,17,17,0,0,0,0,3869,14,3855,3869,1948,1921,3838,42,970800
42,35,970900,243069697,3520,1526,1526,0,1526,1223,303,3520,3520,0,0,3520,3503,3483,8,4,6,2,0,17,17,0,0,0,0,3520,24,3496,3520,1780,1740,3483,42,970900
42,37,50100,250491830,5241,2878,2878,0,2878,2137,741,5241,5241,0,0,5241,5218,5191,3,16,4,0,4,23,23,0,0,0,0,5241,27,5214,5241,2622,2619,5191,42,50100
42,37,50200,234917142,5605,2318,2318,0,2318,2096,222,5605,5605,0,0,5605,5576,5543,8,8,13,0,4,29,26,3,0,0,0,5605,18,5587,5605,2721,2884,5543,42,50200
42,37,50300,114641169,4770,1920,1920,0,1920,1848,72,4770,4770,0,0,4770,4732,4687,14,2,19,0,10,38,38,0,0,0,0,4770,28,4742,4770,2409,2361,4687,42,50300
42,37,50400,75078608,4315,1822,1822,0,1822,1634,188,4315,4315,0,0,4315,4303,4257,20,3,11,6,6,12,12,0,0,0,0,4315,39,4276,4315,2093,2222,4257,42,50400
42,37,50500,59625348,3793,1673,1673,0,1673,1513,160,3793,3793,0,0,3793,3779,3755,7,1,7,0,9,14,14,0,0,0,0,3793,15,3778,3793,1837,1956,3755,42,50500
42,37,50600,4169273,5740,2518,2518,0,2518,2321,197,5740,5740,0,0,5740,5696,5542,49,23,32,2,48,44,33,10,1,0,0,5740,134,5606,5740,2647,3093,5542,42,50600
42,37,50700,3856262,5034,2474,2474,0,2474,2274,200,5034,5034,0,0,5034,5008,4920,46,7,14,3,18,26,23,3,0,0,0,5034,41,4993,5034,2390,2644,4920,42,50700
42,37,50800,7087438,3429,1599,1599,0,1599,1527,72,3429,3429,0,0,3429,3409,3371,11,3,17,0,7,20,19,0,1,0,0,3429,30,3399,3429,1622,1807,3371,42,50800
42,37,50900,23802249,2572,974,974,0,974,949,25,2572,2572,0,0,2572,2559,2500,6,0,50,1,2,13,13,0,0,0,0,2572,12,2560,2572,1238,1334,2500,42,50900
42,37,51000,3752565,2500,1116,1116,0,1116,1069,47,2500,2500,0,0,2500,2473,2395,34,7,16,0,21,27,27,0,0,0,0,2500,46,2454,2500,1194,1306,2395,42,51000
42,37,51100,3003084,5971,1203,1203,0,1203,1151,52,5971,5971,0,0,5971,5916,5544,236,10,63,3,60,55,49,6,0,0,0,5971,123,5848,5971,2422,3549,5544,42,51100
42,37,51200,4617757,3904,2080,2080,0,2080,1860,220,3904,3904,0,0,3904,3873,3745,52,8,58,2,8,31,28,3,0,0,0,3904,46,3858,3904,1786,2118,3745,42,51200
42,37,51300,33163050,3113,1361,1361,0,1361,1279,82,3113,3113,0,0,3113,3091,3046,28,0,7,4,6,22,12,10,0,0,0,3113,15,3098,3113,1466,1647,3046,42,51300
42,37,51400,59150780,2485,1049,1049,0,1049,992,57,2485,2485,0,0,2485,2476,2456,0,4,16,0,0,9,9,0,0,0,0,2485,5,2480,2485,1223,1262,2456,42,51400
42,37,51500,380202557,5679,2748,2748,0,2748,2265,483,5679,5679,0,0,5679,5671,5650,2,2,7,0,10,8,7,1,0,0,0,5679,30,5649,5679,2853,2826,5650,42,51500
42,39,110100,320171292,6116,2893,2893,0,2893,2003,890,6116,6116,0,0,6116,6088,6067,11,7,2,0,1,28,28,0,0,0,0,6116,16,6100,6116,3164,2952,6067,42,110100
42,39,110200,302080058,8033,3201,3201,0,3201,2784,417,8033,8033,0,0,8033,7964,7590,321,14,19,5,15,69,59,10,0,0,0,8033,94,7939,8033,3741,4292,7590,42,110200
42,39,110300,284109980,5163,2136,2136,0,2136,1855,281,5163,5163,0,0,5163,5127,5069,38,8,8,1,3,36,36,0,0,0,0,5163,16,5147,5163,2572,2591,5069,42,110300
42,39,110400,125011981,3236,1689,1689,0,1689,1263,426,3236,3236,0,0,3236,3201,3162,17,16,4,0,2,35,35,0,0,0,0,3236,14,3222,3236,1645,1591,3162,42,110400
42,39,110500,129083718,5821,3880,3880,0,3880,2507,1373,5821,5821,0,0,5821,5799,5770,4,5,17,2,1,22,20,2,0,0,0,5821,21,5800,5821,2895,2926,5770,42,110500
42,39,110600,100665975,3092,1249,1249,0,1249,1155,94,3092,3092,0,0,3092,3080,3063,2,6,7,0,2,12,12,0,0,0,0,3092,11,3081,3092,1570,1522,3063,42,110600
42,39,110700,89488404,4193,1542,1542,0,1542,1444,98,4193,4193,0,0,4193,4164,4079,57,11,4,0,13,29,28,0,0,0,1,4193,13,4180,4193,2123,2070,4079,42,110700
42,39,110800,270598538,5080,2061,2061,0,2061,1868,193,5080,5080,0,0,5080,5056,5032,12,4,6,0,2,24,21,1,2,0,0,5080,24,5056,5080,2637,2443,5032,42,110800
42,39,110900,220143203,3328,1423,1423,0,1423,1191,232,3328,3328,0,0,3328,3312,3281,12,8,6,3,2,16,16,0,0,0,0,3328,17,3311,3328,1680,1648,3281,42,110900
42,39,111000,89267972,2485,1108,1108,0,1108,999,109,2485,2485,0,0,2485,2479,2459,4,7,5,0,4,6,6,0,0,0,0,2485,7,2478,2485,1251,1234,2459,42,111000
42,39,111100,5831423,3549,1581,1581,0,1581,1454,127,3549,3549,0,0,3549,3526,3437,65,15,6,0,3,23,23,0,0,0,0,3549,35,3514,3549,1625,1924,3437,42,111100
42,39,111200,1694222,2597,1161,1161,0,1161,1069,92,2597,2597,0,0,2597,2585,2560,9,3,11,0,2,12,11,1,0,0,0,2597,17,2580,2597,1160,1437,2560,42,111200
42,39,111300,218199497,5707,2612,2612,0,2612,2203,409,5707,5707,0,0,5707,5690,5656,13,6,8,3,4,17,14,3,0,0,0,5707,15,5692,5707,2811,2896,5656,42,111300
42,39,111400,41257453,4736,1977,1977,0,1977,1901,76,4736,4736,0,0,4736,4710,4567,103,11,25,0,4,26,24,2,0,0,0,4736,26,4710,4736,2280,2456,4567,42,111400
42,39,111500,3167121,5287,2560,2560,0,2560,2345,215,5287,5287,0,0,5287,5202,4954,203,7,27,2,9,85,84,1,0,0,0,5287,39,5248,5287,2435,2852,4954,42,111500
42,39,111600,3323561,4162,2175,2175,0,2175,1930,245,4162,4162,0,0,4162,4042,3613,379,11,13,3,23,120,113,7,0,0,0,4162,60,4102,4162,1938,2224,3613,42,111600
42,39,111700,10705013,4727,1457,1457,0,1457,1358,99,4727,4727,0,0,4727,4679,4498,109,7,50,1,14,48,45,3,0,0,0,4727,53,4674,4727,2019,2708,4498,42,111700
42,39,111800,76543735,5499,2599,2599,0,2599,2395,204,5499,5499,0,0,5499,5466,5359,55,16,25,1,10,33,32,0,0,1,0,5499,31,5468,5499,2643,2856,5359,42,111800
42,39,111900,196289919,3580,1387,1387,0,1387,1260,127,3580,3580,0,0,3580,3550,3510,18,13,5,1,3,30,25,5,0,0,0,3580,18,3562,3580,1822,1758,3510,42,111900
42,39,112000,135308321,3975,3725,3725,0,3725,1694,2031,3975,3975,0,0,3975,3948,3927,5,9,6,1,0,27,26,1,0,0,0,3975,10,3965,3975,1957,2018,3927,42,112000
42,41,10100,5597058,4984,2271,2271,0,2271,2148,123,4984,4984,0,0,4984,4888,4754,50,14,41,4,25,96,92,4,0,0,0,4984,81,4903,4984,2362,2622,4754,42,10100
42,41,10201,10905674,3919,1633,1633,0,1633,1582,51,3919,3919,0,0,3919,3873,3790,25,3,41,0,14,46,44,2,0,0,0,3919,27,3892,3919,1916,2003,3790,42,10201
42,41,10202,10587597,8045,3304,3304,0,3304,3188,116,8045,8045,0,0,8045,7950,7304,191,9,374,0,72,95,85,9,1,0,0,8045,161,7884,8045,3771,4274,7304,42,10202
42,41,10300,3429858,3913,1995,1995,0,1995,1852,143,3913,3913,0,0,3913,3836,3665,36,4,116,2,13,77,75,2,0,0,0,3913,47,3866,3913,1908,2005,3665,42,10300
42,41,10400,2748402,3676,1607,1607,0,1607,1568,39,3676,3676,0,0,3676,3641,3564,5,10,57,0,5,35,32,3,0,0,0,3676,29,3647,3676,1763,1913,3564,42,10400
42,41,10500,2959806,3960,1922,1922,0,1922,1819,103,3960,3960,0,0,3960,3927,3773,22,2,115,1,14,33,33,0,0,0,0,3960,54,3906,3960,1821,2139,3773,42,10500
42,41,10600,4032607,3995,2027,2027,0,2027,1926,101,3995,3995,0,0,3995,3956,3856,23,3,52,0,22,39,39,0,0,0,0,3995,43,3952,3995,1893,2102,3856,42,10600
42,41,10700,2494536,3808,1634,1634,0,1634,1606,28,3808,3808,0,0,3808,3782,3728,8,0,32,2,12,26,25,0,1,0,0,3808,35,3773,3808,1813,1995,3728,42,10700
42,41,10800,1841489,3541,1783,1783,0,1783,1695,88,3541,3541,0,0,3541,3502,3415,39,7,21,2,18,39,37,2,0,0,0,3541,48,3493,3541,1723,1818,3415,42,10800
42,41,10900,3685927,4442,2062,2062,0,2062,1994,68,4442,4442,0,0,4442,4425,4267,41,2,100,0,15,17,17,0,0,0,0,4442,50,4392,4442,2068,2374,4267,42,10900
42,41,11000,5852091,5507,1081,1081,0,1081,1048,33,5507,5507,0,0,5507,5474,3583,1790,8,36,1,56,33,33,0,0,0,0,5507,518,4989,5507,4216,1291,3583,42,11000
42,41,11100,17105107,7488,3377,3377,0,3377,3272,105,7488,7488,0,0,7488,7403,7096,58,12,194,9,34,85,83,2,0,0,0,7488,73,7415,7488,3484,4004,7096,42,11100
42,41,11200,771550,1521,742,742,0,742,719,23,1521,1521,0,0,1521,1501,1450,8,1,37,0,5,20,19,1,0,0,0,1521,8,1513,1521,697,824,1450,42,11200
42,41,11301,14901053,2931,1340,1340,0,1340,1270,70,2931,2931,0,0,2931,2912,2790,21,2,87,0,12,19,17,2,0,0,0,2931,36,2895,2931,1422,1509,2790,42,11301
42,41,11302,7620836,5373,2008,2008,0,2008,1962,46,5373,5373,0,0,5373,5333,5098,44,3,167,0,21,40,37,3,0,0,0,5373,63,5310,5373,2633,2740,5098,42,11302
42,41,11303,6743929,6078,2154,2154,0,2154,2111,43,6078,6078,0,0,6078,6032,5723,28,4,264,1,12,46,46,0,0,0,0,6078,52,6026,6078,2979,3099,5723,42,11303
42,41,11304,5880967,5414,2469,2469,0,2469,2388,81,5414,5414,0,0,5414,5335,5017,55,13,222,6,22,79,76,3,0,0,0,5414,60,5354,5414,2480,2934,5017,42,11304
42,41,11305,10878870,4339,2019,2019,0,2019,1846,173,4339,4339,0,0,4339,4312,4052,60,11,164,3,22,27,25,2,0,0,0,4339,78,4261,4339,2200,2139,4052,42,11305
42,41,11400,2900737,4402,2161,2161,0,2161,2054,107,4402,4402,0,0,4402,4345,4238,24,5,71,0,7,57,54,3,0,0,0,4402,42,4360,4402,2108,2294,4238,42,11400
42,41,11500,3800604,4640,2008,2008,0,2008,1969,39,4640,4640,0,0,4640,4599,4530,15,3,33,0,18,41,37,4,0,0,0,4640,33,4607,4640,2207,2433,4530,42,11500
42,41,11601,10536811,5900,2419,2419,0,2419,2347,72,5900,5900,0,0,5900,5857,5556,135,3,94,2,67,43,32,11,0,0,0,5900,112,5788,5900,2562,3338,5556,42,11601
42,41,11602,9319823,3345,1139,1139,0,1139,1119,20,3345,3345,0,0,3345,3326,3258,8,3,53,0,4,19,19,0,0,0,0,3345,18,3327,3345,1671,1674,3258,42,11602
42,41,11603,14493019,6093,1640,1640,0,1640,1591,49,6093,6093,0,0,6093,6024,5832,54,8,106,3,21,69,59,5,4,1,0,6093,89,6004,6093,2756,3337,5832,42,11603
42,41,11700,67705231,5530,2165,2165,0,2165,2073,92,5530,5530,0,0,5530,5499,5452,12,2,31,1,1,31,24,7,0,0,0,5530,26,5504,5530,2780,2750,5452,42,11700
42,41,11801,64134909,5885,2333,2333,0,2333,2251,82,5885,5885,0,0,5885,5845,5706,16,2,93,3,25,40,36,1,1,2,0,5885,45,5840,5885,2904,2981,5706,42,11801
42,41,11802,20065575,4707,1852,1852,0,1852,1810,42,4707,4707,0,0,4707,4666,4478,23,6,151,1,7,41,37,4,0,0,0,4707,32,4675,4707,2289,2418,4478,42,11802
42,41,11803,66949113,6669,2392,2392,0,2392,2298,94,6669,6669,0,0,6669,6593,6401,100,7,53,3,29,76,69,7,0,0,0,6669,84,6585,6669,3416,3253,6401,42,11803
42,41,11901,47004873,4177,1747,1747,0,1747,1674,73,4177,4177,0,0,4177,4145,4006,72,11,39,0,17,32,27,4,1,0,0,4177,33,4144,4177,2047,2130,4006,42,11901
42,41,11902,14138831,6020,2466,2466,0,2466,2365,101,6020,6020,0,0,6020,5944,5482,276,9,119,11,47,76,73,2,1,0,0,6020,118,5902,6020,2893,3127,5482,42,11902
42,41,12000,3367237,4364,2039,2039,0,2039,1885,154,4364,4364,0,0,4364,4289,3696,456,5,86,0,46,75,67,4,1,3,0,4364,104,4260,4364,2057,2307,3696,42,12000
42,41,12100,1561375,2183,1087,1087,0,1087,1004,83,2183,2183,0,0,2183,2131,1921,140,5,37,0,28,52,46,6,0,0,0,2183,50,2133,2183,1051,1132,1921,42,12100
42,41,12200,483773,1914,1141,1141,0,1141,974,167,1914,1914,0,0,1914,1889,1717,135,5,19,0,13,25,21,4,0,0,0,1914,60,1854,1914,975,939,1717,42,12200
42,41,12300,743395,2445,890,890,0,890,806,84,2445,2445,0,0,2445,2373,2012,304,6,37,2,12,72,63,7,0,2,0,2445,46,2399,2445,1000,1445,2012,42,12300
42,41,12400,7909807,7064,2875,2875,0,2875,2757,118,7064,7064,0,0,7064,6985,6634,208,5,109,1,28,79,75,3,1,0,0,7064,92,6972,7064,3131,3933,6634,42,12400
42,41,12500,59896782,9393,3965,3965,0,3965,3797,168,9393,9393,0,0,9393,9324,9111,56,6,108,8,35,69,63,2,4,0,0,9393,89,9304,9393,4505,4888,9111,42,12500
42,41,12600,72128077,5471,2263,2263,0,2263,2120,143,5471,5471,0,0,5471,5436,5343,48,4,24,3,14,35,30,5,0,0,0,5471,50,5421,5471,2753,2718,5343,42,12600
42,41,12700,274026378,8916,3377,3377,0,3377,3200,177,8916,8916,0,0,8916,8867,8764,33,15,29,2,24,49,35,14,0,0,0,8916,49,8867,8916,4459,4457,8764,42,12700
42,41,12800,137264076,7432,2800,2800,0,2800,2704,96,7432,7432,0,0,7432,7397,7329,25,8,25,1,9,35,31,4,0,0,0,7432,32,7400,7432,3688,3744,7329,42,12800
42,41,12900,1147958,1367,620,620,0,620,579,41,1367,1367,0,0,1367,1348,1327,12,3,0,0,6,19,19,0,0,0,0,1367,16,1351,1367,667,700,1327,42,12900
42,41,13000,208098966,6597,2511,2511,0,2511,2390,121,6597,6597,0,0,6597,6559,6495,23,17,15,0,9,38,35,3,0,0,0,6597,40,6557,6597,3337,3260,6495,42,13000
42,41,13101,209397126,7363,2652,2652,0,2652,2527,125,7363,7363,0,0,7363,7309,7215,34,18,26,2,14,54,52,1,0,1,0,7363,51,7312,7363,3680,3683,7215,42,13101
42,41,13102,6304659,4379,879,879,0,879,803,76,4379,4379,0,0,4379,4333,4095,166,2,51,2,17,46,42,4,0,0,0,4379,51,4328,4379,2067,2312,4095,42,13102
42,41,13200,3507772,4484,2102,2102,0,2102,1924,178,4484,4484,0,0,4484,4441,4193,169,6,49,1,23,43,43,0,0,0,0,4484,58,4426,4484,2061,2423,4193,42,13200
42,43,20100,2330998,2968,2496,2496,0,2496,2036,460,2968,2968,0,0,2968,2876,1885,851,10,65,3,62,92,83,7,2,0,0,2968,136,2832,2968,1570,1398,1885,42,20100
42,43,20300,378184,1746,1319,1319,0,1319,1099,220,1746,1746,0,0,1746,1661,716,863,4,16,1,61,85,81,4,0,0,0,1746,132,1614,1746,894,852,716,42,20300
42,43,20400,199219,1656,1195,1195,0,1195,1030,165,1656,1656,0,0,1656,1592,1168,352,6,41,1,24,64,54,4,4,1,1,1656,48,1608,1656,864,792,1168,42,20400
42,43,20500,710720,3103,1774,1774,0,1774,1431,343,3103,3103,0,0,3103,3005,1319,1524,9,45,1,107,98,86,10,2,0,0,3103,202,2901,3103,1555,1548,1319,42,20500
42,43,20600,374265,1391,534,534,0,534,449,85,1391,1391,0,0,1391,1349,203,1055,8,30,0,53,42,34,5,3,0,0,1391,108,1283,1391,581,810,203,42,20600
42,43,20700,524382,2954,1181,1181,0,1181,941,240,2954,2954,0,0,2954,2850,227,2477,3,30,5,108,104,95,9,0,0,0,2954,181,2773,2954,1317,1637,227,42,20700
42,43,20800,532310,2704,1391,1391,0,1391,1193,198,2704,2704,0,0,2704,2604,917,1532,8,55,2,90,100,86,13,1,0,0,2704,177,2527,2704,1340,1364,917,42,20800
42,43,20900,2089499,3636,1709,1709,0,1709,1521,188,3636,3636,0,0,3636,3557,1522,1878,17,33,1,106,79,69,10,0,0,0,3636,217,3419,3636,1660,1976,1522,42,20900
42,43,21100,6384376,3069,1463,1463,0,1463,1205,258,3069,3069,0,0,3069,2975,313,2469,17,29,1,146,94,82,10,1,1,0,3069,266,2803,3069,1339,1730,313,42,21100
42,43,21200,441478,2372,1116,1116,0,1116,793,323,2372,2372,0,0,2372,2269,284,1806,2,39,0,138,103,100,2,1,0,0,2372,252,2120,2372,1161,1211,284,42,21200
42,43,21300,1214093,6533,2795,2795,0,2795,2145,650,6533,6533,0,0,6533,6258,1797,3123,34,231,4,1069,275,256,19,0,0,0,6533,1666,4867,6533,3147,3386,1797,42,21300
42,43,21400,2278669,5128,1941,1941,0,1941,1826,115,5128,5128,0,0,5128,4888,1016,2836,19,296,3,718,240,230,10,0,0,0,5128,1378,3750,5128,2178,2950,1016,42,21400
42,43,21500,809928,3479,1513,1513,0,1513,1353,160,3479,3479,0,0,3479,3351,984,2042,13,76,5,231,128,124,4,0,0,0,3479,414,3065,3479,1635,1844,984,42,21500
42,43,21600,677650,2645,1225,1225,0,1225,1030,195,2645,2645,0,0,2645,2525,418,1985,14,18,1,89,120,100,18,2,0,0,2645,188,2457,2645,1210,1435,418,42,21600
42,43,21700,2059620,5566,2662,2662,0,2662,2509,153,5566,5566,0,0,5566,5409,2758,2048,19,380,7,197,157,143,13,1,0,0,5566,359,5207,5566,2555,3011,2758,42,21700
42,43,21800,2635763,2194,980,980,0,980,936,44,2194,2194,0,0,2194,2161,1822,271,0,34,2,32,33,32,1,0,0,0,2194,70,2124,2194,1071,1123,1822,42,21800
42,43,21900,24000222,10599,4466,4466,0,4466,4248,218,10599,10599,0,0,10599,10421,8128,1938,12,262,0,81,178,163,13,2,0,0,10599,190,10409,10599,5080,5519,8128,42,21900
42,43,22000,4295305,5067,2373,2373,0,2373,2274,99,5067,5067,0,0,5067,4913,3146,1602,9,78,1,77,154,134,19,1,0,0,5067,148,4919,5067,2357,2710,3146,42,22000
42,43,22100,3797424,4035,1774,1774,0,1774,1720,54,4035,4035,0,0,4035,3966,3391,430,3,105,1,36,69,67,2,0,0,0,4035,84,3951,4035,1790,2245,3391,42,22100
42,43,22200,1188044,3044,1398,1398,0,1398,1307,91,3044,3044,0,0,3044,2931,2354,464,7,49,0,57,113,110,3,0,0,0,3044,140,2904,3044,1474,1570,2354,42,22200
42,43,22300,3509447,5599,2673,2673,0,2673,2538,135,5599,5599,0,0,5599,5513,4806,513,9,116,3,66,86,81,5,0,0,0,5599,147,5452,5599,2576,3023,4806,42,22300
42,43,22401,7186734,3320,1320,1320,0,1320,1275,45,3320,3320,0,0,3320,3289,3040,172,4,56,0,17,31,30,1,0,0,0,3320,43,3277,3320,1624,1696,3040,42,22401
42,43,22403,6254611,6211,3156,3156,0,3156,2965,191,6211,6211,0,0,6211,6110,5072,591,7,320,3,117,101,91,10,0,0,0,6211,223,5988,6211,2969,3242,5072,42,22403
42,43,22501,18234051,5274,1886,1886,0,1886,1833,53,5274,5274,0,0,5274,5238,4898,191,5,120,1,23,36,32,4,0,0,0,5274,76,5198,5274,2544,2730,4898,42,22501
42,43,22502,8891136,5658,2283,2283,0,2283,2217,66,5658,5658,0,0,5658,5613,5414,107,5,80,1,6,45,44,1,0,0,0,5658,49,5609,5658,2726,2932,5414,42,22502
42,43,22601,8737949,6814,2890,2890,0,2890,2800,90,6814,6814,0,0,6814,6745,6252,312,2,117,1,61,69,60,8,1,0,0,6814,111,6703,6814,3296,3518,6252,42,22601
42,43,22603,9116671,7225,3498,3498,0,3498,3185,313,7225,7225,0,0,7225,7049,5186,1438,11,262,0,152,176,168,8,0,0,0,7225,304,6921,7225,3415,3810,5186,42,22603
42,43,22604,10850451,4323,1900,1900,0,1900,1771,129,4323,4323,0,0,4323,4268,3763,356,3,123,1,22,55,51,0,4,0,0,4323,100,4223,4323,2070,2253,3763,42,22604
42,43,22700,6881646,7764,3351,3351,0,3351,3251,100,7764,7764,0,0,7764,7611,6519,861,7,134,2,88,153,147,6,0,0,0,7764,248,7516,7764,3634,4130,6519,42,22700
42,43,22800,13512604,5017,2107,2107,0,2107,2033,74,5017,5017,0,0,5017,4915,4325,381,9,87,4,109,102,83,19,0,0,0,5017,178,4839,5017,2424,2593,4325,42,22800
42,43,22900,12419723,7958,2712,2712,0,2712,2551,161,7958,7958,0,0,7958,7752,5164,2239,12,142,5,190,206,193,12,1,0,0,7958,595,7363,7958,4161,3797,5164,42,22900
42,43,23000,1464293,1872,898,898,0,898,868,30,1872,1872,0,0,1872,1840,1672,132,0,31,0,5,32,32,0,0,0,0,1872,50,1822,1872,888,984,1672,42,23000
42,43,23100,1083293,1570,703,703,0,703,670,33,1570,1570,0,0,1570,1542,1390,100,2,24,0,26,28,27,1,0,0,0,1570,63,1507,1570,732,838,1390,42,23100
42,43,23300,1062230,4230,1794,1794,0,1794,1627,167,4230,4230,0,0,4230,4087,2477,1453,6,38,2,111,143,132,11,0,0,0,4230,318,3912,4230,1985,2245,2477,42,23300
42,43,23400,3656035,1628,739,739,0,739,685,54,1628,1628,0,0,1628,1564,1157,370,7,0,0,30,64,55,9,0,0,0,1628,120,1508,1628,741,887,1157,42,23400
42,43,23500,1872323,2720,1373,1373,0,1373,1279,94,2720,2720,0,0,2720,2665,2356,223,3,24,0,59,55,52,3,0,0,0,2720,139,2581,2720,1309,1411,2356,42,23500
42,43,23600,31391880,8149,3124,3124,0,3124,3003,121,8149,8149,0,0,8149,8063,7636,250,4,125,1,47,86,78,7,0,1,0,8149,156,7993,8149,3989,4160,7636,42,23600
42,43,23700,1036512,1553,744,744,0,744,671,73,1553,1553,0,0,1553,1481,1098,327,15,3,1,37,72,70,0,2,0,0,1553,106,1447,1553,714,839,1098,42,23700
42,43,23800,1485900,3845,2006,2006,0,2006,1789,217,3845,3845,0,0,3845,3761,3444,255,4,25,1,32,84,81,3,0,0,0,3845,128,3717,3845,1763,2082,3444,42,23800
42,43,23900,2754006,3844,1637,1637,0,1637,1572,65,3844,3844,0,0,3844,3803,3662,96,6,21,2,16,41,37,2,1,1,0,3844,60,3784,3844,1766,2078,3662,42,23900
42,43,24001,59879040,6187,2510,2510,0,2510,2399,111,6187,6187,0,0,6187,6118,6025,45,8,26,0,14,69,64,4,0,1,0,6187,59,6128,6187,3010,3177,6025,42,24001
42,43,24002,43341608,2847,1069,1069,0,1069,1019,50,2847,2847,0,0,2847,2827,2779,23,0,11,4,10,20,17,3,0,0,0,2847,27,2820,2847,1436,1411,2779,42,24002
42,43,24101,17058888,1641,907,907,0,907,790,117,1641,1641,0,0,1641,1601,1380,63,1,142,0,15,40,39,1,0,0,0,1641,43,1598,1641,784,857,1380,42,24101
42,43,24102,18395310,3477,1498,1498,0,1498,1415,83,3477,3477,0,0,3477,3442,3250,84,1,98,0,9,35,31,4,0,0,0,3477,40,3437,3477,1645,1832,3250,42,24102
42,43,24103,25300323,10114,3985,3985,0,3985,3808,177,10114,10114,0,0,10114,10034,9341,126,9,520,0,38,80,76,4,0,0,0,10114,120,9994,10114,4798,5316,9341,42,24103
42,43,24200,6352169,2548,1337,1337,0,1337,1191,146,2548,2548,0,0,2548,2508,2403,51,2,35,4,13,40,36,4,0,0,0,2548,51,2497,2548,1216,1332,2403,42,24200
42,43,24300,3169094,3493,1754,1754,0,1754,1657,97,3493,3493,0,0,3493,3435,3336,31,2,48,1,17,58,57,1,0,0,0,3493,43,3450,3493,1609,1884,3336,42,24300
42,43,24400,3492223,4360,1953,1953,0,1953,1879,74,4360,4360,0,0,4360,4323,4230,14,1,46,3,29,37,28,8,1,0,0,4360,66,4294,4360,2124,2236,4230,42,24400
42,43,24502,103326084,5322,2043,2043,0,2043,1966,77,5322,5322,0,0,5322,5264,5160,38,7,22,0,37,58,58,0,0,0,0,5322,101,5221,5322,2649,2673,5160,42,24502
42,43,24503,29155503,4793,1772,1772,0,1772,1706,66,4793,4793,0,0,4793,4758,4679,16,14,45,0,4,35,32,2,0,1,0,4793,38,4755,4793,2402,2391,4679,42,24503
42,43,24600,60575283,6505,2584,2584,0,2584,2502,82,6505,6505,0,0,6505,6483,6332,75,2,65,2,7,22,22,0,0,0,0,6505,35,6470,6505,3233,3272,6332,42,24600
42,43,24700,203111890,5776,2400,2400,0,2400,2281,119,5776,5776,0,0,5776,5737,5661,17,8,25,1,25,39,33,1,0,5,0,5776,39,5737,5776,2904,2872,5661,42,24700
42,43,24800,288236624,7625,3076,3076,0,3076,2917,159,7625,7625,0,0,7625,7583,7504,18,3,27,0,31,42,40,1,1,0,0,7625,60,7565,7625,3808,3817,7504,42,24800
42,43,24900,23391375,2568,1220,1220,0,1220,1065,155,2568,2568,0,0,2568,2551,2536,4,4,3,0,4,17,17,0,0,0,0,2568,15,2553,2568,1263,1305,2536,42,24900
42,43,25000,29568251,3105,1455,1455,0,1455,1286,169,3105,3105,0,0,3105,3080,3041,9,7,20,0,3,25,23,2,0,0,0,3105,11,3094,3105,1519,1586,3041,42,25000
42,43,25100,118919179,3091,1224,1224,0,1224,1154,70,3091,3091,0,0,3091,3081,3063,13,2,0,0,3,10,10,0,0,0,0,3091,9,3082,3091,1587,1504,3063,42,25100
42,43,25200,49585402,3391,1404,1404,0,1404,1335,69,3391,3391,0,0,3391,3367,3328,18,1,15,0,5,24,21,3,0,0,0,3391,34,3357,3391,1676,1715,3328,42,25200
42,43,25300,67294488,3930,1528,1528,0,1528,1458,70,3930,3930,0,0,3930,3922,3887,16,5,10,0,4,8,8,0,0,0,0,3930,15,3915,3930,1910,2020,3887,42,25300
42,43,25400,2016787,2562,1315,1315,0,1315,1213,102,2562,2562,0,0,2562,2554,2524,6,3,13,0,8,8,8,0,0,0,0,2562,28,2534,2562,1176,1386,2524,42,25400
42,45,400100,177638,943,420,420,0,420,366,54,943,943,0,0,943,901,201,162,2,512,0,24,42,42,0,0,0,0,943,57,886,943,501,442,201,42,400100
42,45,400200,655157,3853,1188,1188,0,1188,1126,62,3853,3853,0,0,3853,3656,1124,567,5,1913,0,47,197,187,9,1,0,0,3853,53,3800,3853,1930,1923,1124,42,400200
42,45,400301,768209,6229,2731,2731,0,2731,2514,217,6229,6229,0,0,6229,6052,3588,1953,23,408,9,71,177,161,16,0,0,0,6229,180,6049,6229,2869,3360,3588,42,400301
42,45,400302,1094906,3675,1489,1489,0,1489,1358,131,3675,3675,0,0,3675,3557,2565,854,6,112,0,20,118,109,7,2,0,0,3675,92,3583,3675,1712,1963,2565,42,400302
42,45,400401,507690,4765,1956,1956,0,1956,1830,126,4765,4765,0,0,4765,4612,2491,1118,6,954,1,42,153,141,10,2,0,0,4765,119,4646,4765,2340,2425,2491,42,400401
42,45,400402,329637,3992,1799,1799,0,1799,1662,137,3992,3992,0,0,3992,3826,2173,1092,5,534,3,19,166,154,11,1,0,0,3992,103,3889,3992,1909,2083,2173,42,400402
42,45,400500,1250139,4140,1718,1718,0,1718,1624,94,4140,4140,0,0,4140,4005,3189,533,5,240,0,38,135,134,1,0,0,0,4140,113,4027,4140,2030,2110,3189,42,400500
42,45,400600,1398693,5086,2154,2154,0,2154,2052,102,5086,5086,0,0,5086,5023,4629,186,8,173,1,26,63,55,7,0,1,0,5086,88,4998,5086,2415,2671,4629,42,400600
42,45,400700,1376392,5114,1831,1831,0,1831,1737,94,5114,5114,0,0,5114,5030,3519,787,3,689,0,32,84,73,8,3,0,0,5114,91,5023,5114,2440,2674,3519,42,400700
42,45,400801,362685,1847,1109,1109,0,1109,970,139,1847,1847,0,0,1847,1777,518,837,0,409,0,13,70,62,8,0,0,0,1847,56,1791,1847,896,951,518,42,400801
42,45,400802,958233,3455,1392,1392,0,1392,1335,57,3455,3455,0,0,3455,3412,3138,165,2,87,0,20,43,42,1,0,0,0,3455,38,3417,3455,1678,1777,3138,42,400802
42,45,400900,607793,1681,583,583,0,583,573,10,1681,1681,0,0,1681,1671,1626,18,8,17,0,2,10,9,1,0,0,0,1681,12,1669,1681,813,868,1626,42,400900
42,45,401000,1029477,1991,763,763,0,763,742,21,1991,1991,0,0,1991,1981,1927,25,1,19,3,6,10,8,2,0,0,0,1991,12,1979,1991,921,1070,1927,42,401000
42,45,401101,435687,2853,1282,1282,0,1282,1227,55,2853,2853,0,0,2853,2838,2780,33,4,14,0,7,15,14,1,0,0,0,2853,27,2826,2853,1346,1507,2780,42,401101
42,45,401103,973293,3557,1270,1270,0,1270,1236,34,3557,3557,0,0,3557,3528,3367,71,2,78,0,10,29,27,1,1,0,0,3557,37,3520,3557,1743,1814,3367,42,401103
42,45,401104,1202249,4360,1721,1721,0,1721,1667,54,4360,4360,0,0,4360,4326,4185,72,4,65,0,0,34,33,1,0,0,0,4360,34,4326,4360,2096,2264,4185,42,401104
42,45,401200,1525396,3780,1635,1635,0,1635,1586,49,3780,3780,0,0,3780,3763,3664,44,1,53,0,1,17,17,0,0,0,0,3780,26,3754,3780,1775,2005,3664,42,401200
42,45,401301,495384,2351,1329,1329,0,1329,1251,78,2351,2351,0,0,2351,2311,1414,174,5,693,0,25,40,35,5,0,0,0,2351,70,2281,2351,1109,1242,1414,42,401301
42,45,401302,830529,3197,1322,1322,0,1322,1277,45,3197,3197,0,0,3197,3169,3053,40,5,63,0,8,28,28,0,0,0,0,3197,23,3174,3197,1547,1650,3053,42,401302
42,45,401401,530165,2116,843,843,0,843,821,22,2116,2116,0,0,2116,2106,2017,20,0,67,0,2,10,9,1,0,0,0,2116,9,2107,2116,1003,1113,2017,42,401401
42,45,401402,736799,4048,1815,1815,0,1815,1744,71,4048,4048,0,0,4048,4014,3839,104,1,61,1,8,34,28,3,3,0,0,4048,45,4003,4048,1885,2163,3839,42,401402
42,45,401501,700713,3536,1446,1446,0,1446,1405,41,3536,3536,0,0,3536,3523,3484,17,3,15,0,4,13,13,0,0,0,0,3536,30,3506,3536,1642,1894,3484,42,401501
42,45,401502,1752514,4329,2112,2112,0,2112,2008,104,4329,4329,0,0,4329,4259,3420,353,5,465,3,13,70,68,2,0,0,0,4329,60,4269,4329,2136,2193,3420,42,401502
42,45,401600,859260,1866,834,834,0,834,806,28,1866,1866,0,0,1866,1844,1512,207,0,117,0,8,22,22,0,0,0,0,1866,25,1841,1866,890,976,1512,42,401600
42,45,401700,535064,2586,1012,1012,0,1012,938,74,2586,2586,0,0,2586,2542,1842,530,2,156,0,12,44,39,5,0,0,0,2586,32,2554,2586,1294,1292,1842,42,401700
42,45,401800,898093,3732,1595,1595,0,1595,1473,122,3732,3732,0,0,3732,3622,2733,727,3,137,0,22,110,103,7,0,0,0,3732,53,3679,3732,1776,1956,2733,42,401800
42,45,401900,1320199,4739,2035,2035,0,2035,1974,61,4739,4739,0,0,4739,4678,3942,579,6,134,1,16,61,60,1,0,0,0,4739,59,4680,4739,2231,2508,3942,42,401900
42,45,402000,830505,2573,1369,1369,0,1369,1277,92,2573,2573,0,0,2573,2482,1636,790,1,46,0,9,91,80,11,0,0,0,2573,51,2522,2573,1170,1403,1636,42,402000
42,45,402100,2507309,5981,2321,2321,0,2321,2206,115,5981,5981,0,0,5981,5856,1081,4680,7,62,0,26,125,111,13,1,0,0,5981,69,5912,5981,2718,3263,1081,42,402100
42,45,402200,888060,2281,944,944,0,944,875,69,2281,2281,0,0,2281,2238,432,1758,10,28,0,10,43,40,3,0,0,0,2281,19,2262,2281,916,1365,432,42,402200
42,45,402300,779348,3500,1693,1693,0,1693,1615,78,3500,3500,0,0,3500,3415,317,3062,8,15,1,12,85,74,11,0,0,0,3500,32,3468,3500,1583,1917,317,42,402300
42,45,402400,478952,3535,1388,1388,0,1388,1173,215,3535,3535,0,0,3535,3431,848,2509,4,37,3,30,104,93,11,0,0,0,3535,49,3486,3535,1656,1879,848,42,402400
42,45,402500,661182,3398,1470,1470,0,1470,1231,239,3398,3398,0,0,3398,3332,616,2678,4,20,1,13,66,61,5,0,0,0,3398,23,3375,3398,1610,1788,616,42,402500
42,45,402600,972760,3366,1141,1141,0,1141,1001,140,3366,3366,0,0,3366,3326,2282,992,6,33,3,10,40,39,1,0,0,0,3366,26,3340,3366,1486,1880,2282,42,402600
42,45,402700,661773,2453,954,954,0,954,850,104,2453,2453,0,0,2453,2369,1046,1279,3,24,0,17,84,78,6,0,0,0,2453,40,2413,2453,1162,1291,1046,42,402700
42,45,402800,1969213,5468,2246,2246,0,2246,2091,155,5468,5468,0,0,5468,5359,3886,1356,5,83,2,27,109,101,6,2,0,0,5468,58,5410,5468,2589,2879,3886,42,402800
42,45,402900,2215431,3375,1379,1379,0,1379,1242,137,3375,3375,0,0,3375,3328,50,3257,4,3,1,13,47,37,6,1,3,0,3375,59,3316,3375,1501,1874,50,42,402900
42,45,403001,516356,3264,1280,1280,0,1280,1250,30,3264,3264,0,0,3264,3259,3247,7,0,3,0,2,5,5,0,0,0,0,3264,10,3254,3264,1534,1730,3247,42,403001
42,45,403002,966102,2983,1209,1209,0,1209,1178,31,2983,2983,0,0,2983,2970,2697,234,7,17,2,13,13,12,1,0,0,0,2983,17,2966,2983,1405,1578,2697,42,403002
42,45,403101,860497,3560,1378,1378,0,1378,1312,66,3560,3560,0,0,3560,3524,3330,113,5,60,0,16,36,34,2,0,0,0,3560,31,3529,3560,1731,1829,3330,42,403101
42,45,403103,985904,2686,1068,1068,0,1068,1007,61,2686,2686,0,0,2686,2658,2474,121,9,53,0,1,28,27,1,0,0,0,2686,18,2668,2686,1320,1366,2474,42,403103
42,45,403104,398491,2418,958,958,0,958,869,89,2418,2418,0,0,2418,2378,2162,173,11,27,1,4,40,36,2,2,0,0,2418,28,2390,2418,1155,1263,2162,42,403104
42,45,403200,1543894,4313,1817,1817,0,1817,1751,66,4313,4313,0,0,4313,4282,4024,187,8,58,0,5,31,30,1,0,0,0,4313,40,4273,4313,2046,2267,4024,42,403200
42,45,403300,1613371,6779,2883,2883,0,2883,2714,169,6779,6779,0,0,6779,6717,6387,198,4,102,0,26,62,59,3,0,0,0,6779,67,6712,6779,3308,3471,6387,42,403300
42,45,403401,1025542,3114,1268,1268,0,1268,1200,68,3114,3114,0,0,3114,3078,2767,259,3,33,1,15,36,33,3,0,0,0,3114,47,3067,3114,1511,1603,2767,42,403401
42,45,403402,2482697,3864,1361,1361,0,1361,1330,31,3864,3864,0,0,3864,3844,3784,18,3,33,1,5,20,15,5,0,0,0,3864,30,3834,3864,1903,1961,3784,42,403402
42,45,403501,1448745,4581,1955,1955,0,1955,1860,95,4581,4581,0,0,4581,4524,4143,251,2,114,0,14,57,54,3,0,0,0,4581,57,4524,4581,2226,2355,4143,42,403501
42,45,403502,1074550,2895,1243,1243,0,1243,1198,45,2895,2895,0,0,2895,2874,2756,50,1,64,1,2,21,20,1,0,0,0,2895,31,2864,2895,1323,1572,2756,42,403502
42,45,403601,1115004,4067,1658,1658,0,1658,1595,63,4067,4067,0,0,4067,4046,3941,62,3,33,0,7,21,21,0,0,0,0,4067,30,4037,4067,1975,2092,3941,42,403601
42,45,403602,956134,1918,705,705,0,705,691,14,1918,1918,0,0,1918,1915,1898,4,0,9,0,4,3,3,0,0,0,0,1918,14,1904,1918,925,993,1898,42,403602
42,45,403701,12908315,1895,791,791,0,791,721,70,1895,1895,0,0,1895,1870,1837,20,0,8,0,5,25,24,1,0,0,0,1895,33,1862,1895,952,943,1837,42,403701
42,45,403702,1956397,2458,1085,1085,0,1085,1028,57,2458,2458,0,0,2458,2427,2389,15,3,11,0,9,31,31,0,0,0,0,2458,22,2436,2458,1221,1237,2389,42,403702
42,45,403800,1927648,6594,2683,2683,0,2683,2577,106,6594,6594,0,0,6594,6534,6293,91,8,115,1,26,60,59,1,0,0,0,6594,60,6534,6594,3169,3425,6293,42,403800
42,45,403901,1216351,3485,1681,1681,0,1681,1594,87,3485,3485,0,0,3485,3458,3315,41,1,86,2,13,27,22,5,0,0,0,3485,27,3458,3485,1600,1885,3315,42,403901
42,45,403902,1544922,3711,1486,1486,0,1486,1421,65,3711,3711,0,0,3711,3686,3659,5,0,20,0,2,25,25,0,0,0,0,3711,9,3702,3711,1822,1889,3659,42,403902
42,45,404002,2822828,7195,2872,2872,0,2872,2786,86,7195,7195,0,0,7195,7167,6935,142,1,86,0,3,28,27,1,0,0,0,7195,36,7159,7195,3464,3731,6935,42,404002
42,45,404003,586200,1825,945,945,0,945,887,58,1825,1825,0,0,1825,1804,1511,132,1,154,2,4,21,20,1,0,0,0,1825,27,1798,1825,866,959,1511,42,404003
42,45,404004,2318949,6484,2466,2466,0,2466,2402,64,6484,6484,0,0,6484,6450,6301,66,3,62,5,13,34,34,0,0,0,0,6484,45,6439,6484,3129,3355,6301,42,404004
42,45,404101,2741689,6443,2633,2633,0,2633,2592,41,6443,6443,0,0,6443,6385,5861,402,2,105,1,14,58,50,8,0,0,0,6443,44,6399,6443,2982,3461,5861,42,404101
42,45,404102,2318721,5371,2244,2244,0,2244,2101,143,5371,5371,0,0,5371,5290,4634,555,13,56,6,26,81,78,3,0,0,0,5371,110,5261,5371,2670,2701,4634,42,404102
42,45,404103,2336989,3473,1384,1384,0,1384,1353,31,3473,3473,0,0,3473,3449,3384,16,1,42,0,6,24,24,0,0,0,0,3473,20,3453,3473,1678,1795,3384,42,404103
42,45,404200,347446,860,305,305,0,305,297,8,860,860,0,0,860,853,830,14,1,8,0,0,7,7,0,0,0,0,860,9,851,860,422,438,830,42,404200
42,45,404300,2688436,2442,1035,1035,0,1035,964,71,2442,2442,0,0,2442,2409,2331,43,8,12,0,15,33,33,0,0,0,0,2442,45,2397,2442,1195,1247,2331,42,404300
42,45,404400,557101,1532,734,734,0,734,672,62,1532,1532,0,0,1532,1499,726,701,2,43,0,27,33,29,4,0,0,0,1532,38,1494,1532,736,796,726,42,404400
42,45,404500,1187063,5037,2123,2123,0,2123,1875,248,5037,5037,0,0,5037,4923,1245,3545,6,38,3,86,114,100,14,0,0,0,5037,170,4867,5037,2279,2758,1245,42,404500
42,45,404600,525933,2415,976,976,0,976,885,91,2415,2415,0,0,2415,2357,865,1451,5,4,0,32,58,54,4,0,0,0,2415,72,2343,2415,1123,1292,865,42,404600
42,45,404700,853176,4067,1127,1127,0,1127,1051,76,4067,4067,0,0,4067,4026,1901,1944,17,76,0,88,41,38,2,1,0,0,4067,199,3868,4067,1951,2116,1901,42,404700
42,45,404800,630107,2625,998,998,0,998,814,184,2625,2625,0,0,2625,2558,482,1877,13,0,0,186,67,67,0,0,0,0,2625,352,2273,2625,1179,1446,482,42,404800
42,45,404900,374108,1730,698,698,0,698,548,150,1730,1730,0,0,1730,1701,137,1348,3,5,0,208,29,28,1,0,0,0,1730,294,1436,1730,827,903,137,42,404900
42,45,405000,1184094,2413,1314,1314,0,1314,1046,268,2413,2413,0,0,2413,2369,173,2071,7,24,0,94,44,43,1,0,0,0,2413,184,2229,2413,1181,1232,173,42,405000
42,45,405100,962513,2312,999,999,0,999,895,104,2312,2312,0,0,2312,2301,33,2227,1,7,1,32,11,6,5,0,0,0,2312,56,2256,2312,988,1324,33,42,405100
42,45,405200,762133,2721,1130,1130,0,1130,1059,71,2721,2721,0,0,2721,2694,40,2611,1,0,0,42,27,24,3,0,0,0,2721,88,2633,2721,1120,1601,40,42,405200
42,45,405300,732791,3574,1405,1405,0,1405,1218,187,3574,3574,0,0,3574,3521,463,2957,0,12,0,89,53,52,1,0,0,0,3574,206,3368,3574,1606,1968,463,42,405300
42,45,405400,702743,2379,1075,1075,0,1075,842,233,2379,2379,0,0,2379,2352,402,1912,8,11,0,19,27,27,0,0,0,0,2379,50,2329,2379,1096,1283,402,42,405400
42,45,405600,2743846,1640,313,313,0,313,232,81,1640,1640,0,0,1640,1635,248,1248,3,0,0,136,5,5,0,0,0,0,1640,141,1499,1640,1287,353,248,42,405600
42,45,405700,739470,2035,1023,1023,0,1023,807,216,2035,2035,0,0,2035,2007,222,1733,3,3,0,46,28,21,4,0,3,0,2035,62,1973,2035,928,1107,222,42,405700
42,45,405800,595361,2374,1061,1061,0,1061,870,191,2374,2374,0,0,2374,2355,43,2272,6,3,0,31,19,17,2,0,0,0,2374,74,2300,2374,1061,1313,43,42,405800
42,45,406100,538779,2267,918,918,0,918,869,49,2267,2267,0,0,2267,2249,2168,55,4,13,1,8,18,18,0,0,0,0,2267,40,2227,2267,1106,1161,2168,42,406100
42,45,406201,1642704,2932,1204,1204,0,1204,1167,37,2932,2932,0,0,2932,2921,2838,44,2,24,0,13,11,11,0,0,0,0,2932,27,2905,2932,1356,1576,2838,42,406201
42,45,406202,2752548,5053,2391,2391,0,2391,2309,82,5053,5053,0,0,5053,5017,4799,117,4,75,0,22,36,33,3,0,0,0,5053,63,4990,5053,2371,2682,4799,42,406202
42,45,406300,1736983,2977,1216,1216,0,1216,1116,100,2977,2977,0,0,2977,2928,2299,586,9,10,0,24,49,48,1,0,0,0,2977,62,2915,2977,1402,1575,2299,42,406300
42,45,406401,482423,2935,1025,1025,0,1025,968,57,2935,2935,0,0,2935,2863,801,1990,12,27,1,32,72,66,6,0,0,0,2935,62,2873,2935,1387,1548,801,42,406401
42,45,406402,3129169,1669,729,729,0,729,673,56,1669,1669,0,0,1669,1643,245,1386,0,0,0,12,26,19,7,0,0,0,1669,33,1636,1669,723,946,245,42,406402
42,45,406500,2733289,1901,797,797,0,797,712,85,1901,1901,0,0,1901,1882,1684,175,1,3,0,19,19,19,0,0,0,0,1901,48,1853,1901,930,971,1684,42,406500
42,45,406600,2915464,2314,1025,1025,0,1025,919,106,2314,2314,0,0,2314,2271,2116,123,2,14,0,16,43,39,4,0,0,0,2314,41,2273,2314,1122,1192,2116,42,406600
42,45,406700,2884327,3591,1356,1356,0,1356,1278,78,3591,3591,0,0,3591,3558,3460,73,5,14,0,6,33,32,1,0,0,0,3591,49,3542,3591,1752,1839,3460,42,406700
42,45,406801,6222086,4431,1737,1737,0,1737,1678,59,4431,4431,0,0,4431,4359,3708,542,4,89,0,16,72,62,10,0,0,0,4431,79,4352,4431,2119,2312,3708,42,406801
42,45,406802,4980833,4611,1815,1815,0,1815,1736,79,4611,4611,0,0,4611,4563,3928,588,12,25,1,9,48,45,3,0,0,0,4611,35,4576,4611,2234,2377,3928,42,406802
42,45,406803,6188416,7800,3153,3153,0,3153,3086,67,7800,7800,0,0,7800,7728,6848,614,14,226,0,26,72,67,5,0,0,0,7800,82,7718,7800,3665,4135,6848,42,406803
42,45,406902,4838399,6278,2333,2333,0,2333,2272,61,6278,6278,0,0,6278,6225,6083,58,1,50,2,31,53,53,0,0,0,0,6278,80,6198,6278,3073,3205,6083,42,406902
42,45,406903,3248462,5424,1972,1972,0,1972,1943,29,5424,5424,0,0,5424,5399,5311,47,2,34,1,4,25,23,2,0,0,0,5424,41,5383,5424,2619,2805,5311,42,406903
42,45,406904,6764118,4501,1673,1673,0,1673,1623,50,4501,4501,0,0,4501,4457,4268,134,2,43,0,10,44,38,5,1,0,0,4501,42,4459,4501,2037,2464,4268,42,406904
42,45,407000,5423504,2481,1117,1117,0,1117,1056,61,2481,2481,0,0,2481,2440,2324,57,2,47,3,7,41,41,0,0,0,0,2481,32,2449,2481,1171,1310,2324,42,407000
42,45,407101,7396552,3619,1370,1370,0,1370,1354,16,3619,3619,0,0,3619,3597,3443,62,0,85,1,6,22,21,1,0,0,0,3619,25,3594,3619,1725,1894,3443,42,407101
42,45,407102,4195975,3184,1143,1143,0,1143,1126,17,3184,3184,0,0,3184,3163,3090,45,1,21,2,4,21,15,4,2,0,0,3184,40,3144,3184,1557,1627,3090,42,407102
42,45,407201,16876545,5436,1726,1726,0,1726,1684,42,5436,5436,0,0,5436,5406,5084,201,4,111,0,6,30,28,2,0,0,0,5436,31,5405,5436,2173,3263,5084,42,407201
42,45,407202,6416815,3825,1402,1402,0,1402,1360,42,3825,3825,0,0,3825,3782,3528,187,0,58,0,9,43,38,5,0,0,0,3825,43,3782,3825,1894,1931,3528,42,407202
42,45,407300,1834397,944,351,351,0,351,347,4,944,944,0,0,944,935,900,15,1,16,0,3,9,9,0,0,0,0,944,21,923,944,468,476,900,42,407300
42,45,407401,4553952,3792,1392,1392,0,1392,1370,22,3792,3792,0,0,3792,3747,3056,576,2,102,0,11,45,41,4,0,0,0,3792,35,3757,3792,1818,1974,3056,42,407401
42,45,407403,4184671,6847,2625,2625,0,2625,2554,71,6847,6847,0,0,6847,6773,6417,169,7,162,0,18,74,68,6,0,0,0,6847,83,6764,6847,3243,3604,6417,42,407403
42,45,407404,3456604,2817,1108,1108,0,1108,1083,25,2817,2817,0,0,2817,2794,2648,79,4,51,5,7,23,22,1,0,0,0,2817,34,2783,2817,1343,1474,2648,42,407404
42,45,407501,854657,2288,1221,1221,0,1221,1163,58,2288,2288,0,0,2288,2254,1966,241,3,34,0,10,34,31,3,0,0,0,2288,43,2245,2288,1047,1241,1966,42,407501
42,45,407502,1082135,3245,1745,1745,0,1745,1619,126,3245,3245,0,0,3245,3172,2517,546,5,77,1,26,73,63,9,1,0,0,3245,61,3184,3245,1478,1767,2517,42,407502
42,45,407600,3582713,6170,2064,2064,0,2064,1993,71,6170,6170,0,0,6170,6012,5298,291,15,339,3,66,158,143,15,0,0,0,6170,208,5962,6170,2917,3253,5298,42,407600
42,45,407700,937280,2715,1209,1209,0,1209,1145,64,2715,2715,0,0,2715,2678,1897,664,2,106,0,9,37,30,7,0,0,0,2715,31,2684,2715,1276,1439,1897,42,407700
42,45,407801,4435193,4163,1628,1628,0,1628,1565,63,4163,4163,0,0,4163,4145,4080,15,0,46,0,4,18,16,2,0,0,0,4163,12,4151,4163,1972,2191,4080,42,407801
42,45,407802,4785526,6410,2270,2270,0,2270,2246,24,6410,6410,0,0,6410,6368,6106,48,1,204,0,9,42,42,0,0,0,0,6410,71,6339,6410,3083,3327,6106,42,407802
42,45,407803,2477274,5287,1937,1937,0,1937,1911,26,5287,5287,0,0,5287,5259,5172,17,6,57,0,7,28,26,2,0,0,0,5287,20,5267,5287,2529,2758,5172,42,407803
42,45,407804,2155690,4358,1600,1600,0,1600,1577,23,4358,4358,0,0,4358,4344,4281,7,1,48,3,4,14,11,3,0,0,0,4358,20,4338,4358,2104,2254,4281,42,407804
42,45,407805,1054647,1653,613,613,0,613,585,28,1653,1653,0,0,1653,1645,1576,17,3,49,0,0,8,8,0,0,0,0,1653,6,1647,1653,793,860,1576,42,407805
42,45,407806,1562941,1806,752,752,0,752,734,18,1806,1806,0,0,1806,1788,1653,66,2,62,0,5,18,16,2,0,0,0,1806,17,1789,1806,851,955,1653,42,407806
42,45,407901,9040072,4155,1455,1455,0,1455,1429,26,4155,4155,0,0,4155,4135,3988,49,4,89,0,5,20,20,0,0,0,0,4155,27,4128,4155,2060,2095,3988,42,407901
42,45,407902,3121356,2735,1190,1190,0,1190,1142,48,2735,2735,0,0,2735,2714,2499,158,3,44,0,10,21,20,1,0,0,0,2735,42,2693,2735,1360,1375,2499,42,407902
42,45,407903,2319082,3619,1654,1654,0,1654,1504,150,3619,3619,0,0,3619,3571,3163,203,1,188,0,16,48,45,3,0,0,0,3619,43,3576,3619,1740,1879,3163,42,407903
42,45,408001,5935513,6092,2231,2231,0,2231,2202,29,6092,6092,0,0,6092,6059,5759,25,3,265,0,7,33,33,0,0,0,0,6092,31,6061,6092,2943,3149,5759,42,408001
42,45,408002,9564648,4416,1734,1734,0,1734,1676,58,4416,4416,0,0,4416,4382,4092,65,9,206,0,10,34,34,0,0,0,0,4416,52,4364,4416,1957,2459,4092,42,408002
42,45,408101,4434516,5163,1731,1731,0,1731,1704,27,5163,5163,0,0,5163,5132,4862,76,1,192,0,1,31,31,0,0,0,0,5163,25,5138,5163,2358,2805,4862,42,408101
42,45,408102,2612597,3532,1355,1355,0,1355,1331,24,3532,3532,0,0,3532,3517,3295,19,1,199,0,3,15,15,0,0,0,0,3532,21,3511,3532,1713,1819,3295,42,408102
42,45,408103,3882232,4534,1746,1746,0,1746,1710,36,4534,4534,0,0,4534,4507,3972,76,7,445,0,7,27,26,1,0,0,0,4534,27,4507,4534,2230,2304,3972,42,408103
42,45,408300,4003093,3993,1475,1475,0,1475,1440,35,3993,3993,0,0,3993,3933,3419,383,1,119,0,11,60,49,9,2,0,0,3993,66,3927,3993,1819,2174,3419,42,408300
42,45,408400,4527001,1984,949,949,0,949,926,23,1984,1984,0,0,1984,1978,1895,30,1,52,0,0,6,6,0,0,0,0,1984,16,1968,1984,861,1123,1895,42,408400
42,45,408500,1890472,4004,1572,1572,0,1572,1553,19,4004,4004,0,0,4004,3975,3617,45,1,301,0,11,29,29,0,0,0,0,4004,26,3978,4004,1920,2084,3617,42,408500
42,45,408600,1600272,3555,1340,1340,0,1340,1324,16,3555,3555,0,0,3555,3537,3425,25,12,65,2,8,18,13,5,0,0,0,3555,16,3539,3555,1738,1817,3425,42,408600
42,45,408700,2120296,5017,1817,1817,0,1817,1786,31,5017,5017,0,0,5017,4957,4722,79,14,135,2,5,60,60,0,0,0,0,5017,41,4976,5017,2395,2622,4722,42,408700
42,45,408800,1645226,5013,2088,2088,0,2088,2033,55,5013,5013,0,0,5013,4952,4579,253,4,95,0,21,61,56,5,0,0,0,5013,69,4944,5013,2396,2617,4579,42,408800
42,45,408900,1507112,3054,1105,1105,0,1105,1087,18,3054,3054,0,0,3054,3033,2915,41,0,74,0,3,21,21,0,0,0,0,3054,24,3030,3054,1478,1576,2915,42,408900
42,45,409000,1209292,3651,1366,1366,0,1366,1341,25,3651,3651,0,0,3651,3610,3459,59,2,80,0,10,41,39,2,0,0,0,3651,43,3608,3651,1725,1926,3459,42,409000
42,45,409100,1358090,4221,1511,1511,0,1511,1484,27,4221,4221,0,0,4221,4199,4089,13,1,81,2,13,22,19,3,0,0,0,4221,38,4183,4221,2028,2193,4089,42,409100
42,45,409200,1184317,4136,1518,1518,0,1518,1495,23,4136,4136,0,0,4136,4123,4009,17,4,87,0,6,13,8,5,0,0,0,4136,32,4104,4136,1985,2151,4009,42,409200
42,45,409300,1671702,2388,911,911,0,911,895,16,2388,2388,0,0,2388,2366,2280,11,3,70,0,2,22,19,3,0,0,0,2388,18,2370,2388,1147,1241,2280,42,409300
42,45,409400,1196342,2845,1009,1009,0,1009,994,15,2845,2845,0,0,2845,2829,2698,23,3,101,0,4,16,13,3,0,0,0,2845,15,2830,2845,1308,1537,2698,42,409400
42,45,409500,2014282,4637,1717,1717,0,1717,1703,14,4637,4637,0,0,4637,4612,4478,49,3,78,0,4,25,21,3,1,0,0,4637,27,4610,4637,2251,2386,4478,42,409500
42,45,409601,5836414,4942,1972,1972,0,1972,1940,32,4942,4942,0,0,4942,4893,4149,147,10,564,0,23,49,34,1,13,1,0,4942,64,4878,4942,2211,2731,4149,42,409601
42,45,409602,1055168,3307,1801,1801,0,1801,1713,88,3307,3307,0,0,3307,3246,2783,191,2,253,0,17,61,55,4,2,0,0,3307,61,3246,3307,1472,1835,2783,42,409602
42,45,409701,16243857,6652,1996,1996,0,1996,1941,55,6652,6652,0,0,6652,6603,6080,91,2,395,3,32,49,45,4,0,0,0,6652,96,6556,6652,3214,3438,6080,42,409701
42,45,409702,746488,3352,175,175,0,175,171,4,3352,3352,0,0,3352,3304,3024,99,1,126,0,54,48,45,2,1,0,0,3352,156,3196,3352,1667,1685,3024,42,409702
42,45,409802,5954452,5449,1658,1658,0,1658,1571,87,5449,5449,0,0,5449,5393,5024,173,6,146,2,42,56,55,1,0,0,0,5449,139,5310,5449,2432,3017,5024,42,409802
42,45,409803,5798263,7176,3129,3129,0,3129,3011,118,7176,7176,0,0,7176,7135,6592,252,3,266,0,22,41,30,7,4,0,0,7176,112,7064,7176,3388,3788,6592,42,409803
42,45,409902,7931066,4321,1796,1796,0,1796,1739,57,4321,4321,0,0,4321,4300,4150,27,7,112,0,4,21,18,3,0,0,0,4321,30,4291,4321,1987,2334,4150,42,409902
42,45,409903,3629685,4070,1663,1663,0,1663,1626,37,4070,4070,0,0,4070,4033,3914,21,1,91,0,6,37,35,2,0,0,0,4070,19,4051,4070,1920,2150,3914,42,409903
42,45,409904,14427653,3309,1231,1231,0,1231,1184,47,3309,3309,0,0,3309,3287,3187,29,0,66,0,5,22,22,0,0,0,0,3309,32,3277,3309,1598,1711,3187,42,409904
42,45,410000,25258907,3918,1515,1515,0,1515,1447,68,3918,3918,0,0,3918,3868,3549,192,5,107,0,15,50,46,3,0,0,1,3918,53,3865,3918,1900,2018,3549,42,410000
42,45,410100,23886839,7093,1387,1387,0,1387,1360,27,7093,7093,0,0,7093,7044,4588,2205,8,90,4,149,49,39,9,1,0,0,7093,193,6900,7093,4494,2599,4588,42,410100
42,45,410200,22540360,3170,1338,1338,0,1338,1314,24,3170,3170,0,0,3170,3159,3020,34,2,88,0,15,11,10,1,0,0,0,3170,45,3125,3170,1522,1648,3020,42,410200
42,45,410301,17805081,4882,1650,1650,0,1650,1619,31,4882,4882,0,0,4882,4843,4676,68,2,89,0,8,39,38,1,0,0,0,4882,29,4853,4882,2408,2474,4676,42,410301
42,45,410302,17610041,5051,1901,1901,0,1901,1765,136,5051,5051,0,0,5051,5020,4838,33,7,134,0,8,31,29,2,0,0,0,5051,36,5015,5051,2448,2603,4838,42,410302
42,45,410400,14686714,6421,2017,2017,0,2017,1984,33,6421,6421,0,0,6421,6383,6064,140,2,155,1,21,38,36,1,1,0,0,6421,124,6297,6421,3201,3220,6064,42,410400
42,47,990100,376658112,1721,1175,1175,0,1175,687,488,1721,1721,0,0,1721,1718,1713,1,2,0,0,2,3,3,0,0,0,0,1721,5,1716,1721,899,822,1713,42,990100
42,47,990200,723533948,3666,2925,2925,0,2925,1434,1491,3666,3666,0,0,3666,3651,3637,5,3,3,0,3,15,15,0,0,0,0,3666,9,3657,3666,1858,1808,3637,42,990200
42,47,990400,6902476,4591,2089,2089,0,2089,1927,162,4591,4591,0,0,4591,4574,4524,8,2,32,0,8,17,17,0,0,0,0,4591,24,4567,4591,2190,2401,4524,42,990400
42,47,990500,7859389,3003,1435,1435,0,1435,1292,143,3003,3003,0,0,3003,2993,2968,1,9,11,1,3,10,10,0,0,0,0,3003,39,2964,3003,1477,1526,2968,42,990500
42,47,990900,452178353,2321,2062,2062,0,2062,977,1085,2321,2321,0,0,2321,2315,2304,1,1,9,0,0,6,6,0,0,0,0,2321,16,2305,2321,1143,1178,2304,42,990900
42,47,991000,321821259,5308,2337,2337,0,2337,2084,253,5308,5308,0,0,5308,5296,5279,3,5,6,1,2,12,11,1,0,0,0,5308,5,5303,5308,2725,2583,5279,42,991000
42,47,991100,92670903,6278,2707,2707,0,2707,2530,177,6278,6278,0,0,6278,6263,6200,12,4,34,1,12,15,15,0,0,0,0,6278,28,6250,6278,2963,3315,6200,42,991100
42,47,991200,106992887,2259,930,930,0,930,842,88,2259,2259,0,0,2259,2249,2220,9,5,2,11,2,10,6,4,0,0,0,2259,4,2255,2259,1169,1090,2220,42,991200
42,47,991300,57581238,5965,2455,2455,0,2455,2351,104,5965,5965,0,0,5965,5945,5901,12,2,25,1,4,20,20,0,0,0,0,5965,12,5953,5965,2957,3008,5901,42,991300
42,49,0,0,0,0,0,0,0,0,0,0,0,0,0,0,0,0,0,0,0,0,0,0,0,0,0,0,0,0,0,0,0,0,0,0,42,0
42,49,100,759747,2481,1235,1235,0,1235,1073,162,2481,2481,0,0,2481,2436,2144,266,7,14,0,5,45,38,7,0,0,0,2481,38,2443,2481,1067,1414,2144,42,100
42,49,200,2723576,4133,2037,2037,0,2037,1928,109,4133,4133,0,0,4133,4097,4005,49,3,10,2,28,36,36,0,0,0,0,4133,93,4040,4133,1839,2294,4005,42,200
42,49,300,1656153,3610,1721,1721,0,1721,1471,250,3610,3610,0,0,3610,3483,2336,1018,18,27,0,84,127,118,9,0,0,0,3610,178,3432,3610,1831,1779,2336,42,300
42,49,400,2404064,2909,1220,1220,0,1220,1028,192,2909,2909,0,0,2909,2859,2255,525,6,39,2,32,50,46,4,0,0,0,2909,116,2793,2909,1505,1404,2255,42,400
42,49,500,959646,3225,1476,1476,0,1476,1290,186,3225,3225,0,0,3225,3101,2609,394,4,6,0,88,124,119,5,0,0,0,3225,193,3032,3225,1531,1694,2609,42,500
42,49,600,2671167,3283,1492,1492,0,1492,1333,159,3283,3283,0,0,3283,3145,2368,573,7,10,1,186,138,124,14,0,0,0,3283,313,2970,3283,1505,1778,2368,42,600
42,49,700,730247,2983,1248,1248,0,1248,1084,164,2983,2983,0,0,2983,2884,2053,658,15,12,0,146,99,98,1,0,0,0,2983,276,2707,2983,1428,1555,2053,42,700
42,49,800,755730,3441,1552,1552,0,1552,1305,247,3441,3441,0,0,3441,3267,2249,898,16,49,0,55,174,169,5,0,0,0,3441,268,3173,3441,1748,1693,2249,42,800
42,49,900,964925,4948,2606,2606,0,2606,2265,341,4948,4948,0,0,4948,4806,4235,452,2,60,2,55,142,136,6,0,0,0,4948,148,4800,4948,2431,2517,4235,42,900
42,49,1000,1255387,3519,1718,1718,0,1718,1511,207,3519,3519,0,0,3519,3422,3006,366,6,28,1,15,97,93,3,0,1,0,3519,92,3427,3519,1712,1807,3006,42,1000
42,49,1100,3152052,2832,1147,1147,0,1147,1092,55,2832,2832,0,0,2832,2796,2438,245,5,24,0,84,36,35,1,0,0,0,2832,151,2681,2832,1353,1479,2438,42,1100
42,49,1200,1624142,2728,1293,1293,0,1293,1043,250,2728,2728,0,0,2728,2579,1878,526,13,18,0,144,149,144,4,1,0,0,2728,356,2372,2728,1364,1364,1878,42,1200
42,49,1300,1021136,1830,734,734,0,734,634,100,1830,1830,0,0,1830,1766,585,1086,15,23,4,53,64,63,1,0,0,0,1830,183,1647,1830,835,995,585,42,1300
42,49,1400,844667,1804,627,627,0,627,542,85,1804,1804,0,0,1804,1758,1210,457,12,5,0,74,46,45,1,0,0,0,1804,191,1613,1804,1104,700,1210,42,1400
42,49,1500,2542392,2794,1023,1023,0,1023,907,116,2794,2794,0,0,2794,2633,954,1419,8,44,0,208,161,156,5,0,0,0,2794,369,2425,2794,1321,1473,954,42,1500
42,49,1600,3553035,4267,1675,1675,0,1675,1587,88,4267,4267,0,0,4267,4140,3029,949,8,55,5,94,127,125,2,0,0,0,4267,199,4068,4267,2061,2206,3029,42,1600
42,49,1700,580842,3024,1205,1205,0,1205,1032,173,3024,3024,0,0,3024,2888,1752,976,15,19,0,126,136,133,3,0,0,0,3024,257,2767,3024,1452,1572,1752,42,1700
42,49,1800,617899,2576,1027,1027,0,1027,858,169,2576,2576,0,0,2576,2469,806,1502,6,14,9,132,107,98,9,0,0,0,2576,217,2359,2576,1214,1362,806,42,1800
42,49,1900,555632,2204,1057,1057,0,1057,948,109,2204,2204,0,0,2204,2141,1902,191,5,7,0,36,63,63,0,0,0,0,2204,89,2115,2204,916,1288,1902,42,1900
42,49,2000,1122131,3536,1507,1507,0,1507,1394,113,3536,3536,0,0,3536,3472,3246,163,9,22,2,30,64,63,1,0,0,0,3536,118,3418,3536,1745,1791,3246,42,2000
42,49,2100,2084500,3755,1679,1679,0,1679,1648,31,3755,3755,0,0,3755,3741,3666,30,6,17,0,22,14,14,0,0,0,0,3755,42,3713,3755,1777,1978,3666,42,2100
42,49,2200,1143157,3968,1709,1709,0,1709,1641,68,3968,3968,0,0,3968,3930,3825,43,7,18,0,37,38,36,2,0,0,0,3968,86,3882,3968,1873,2095,3825,42,2200
42,49,2300,818389,2771,1230,1230,0,1230,1173,57,2771,2771,0,0,2771,2733,2644,42,10,20,0,17,38,29,9,0,0,0,2771,54,2717,2771,1310,1461,2644,42,2300
42,49,2400,1208840,3319,1495,1495,0,1495,1367,128,3319,3319,0,0,3319,3265,3043,163,6,7,5,41,54,51,3,0,0,0,3319,61,3258,3319,1596,1723,3043,42,2400
42,49,2500,672628,2561,1031,1031,0,1031,952,79,2561,2561,0,0,2561,2523,2121,350,5,15,0,32,38,35,3,0,0,0,2561,72,2489,2561,1239,1322,2121,42,2500
42,49,2600,1195563,4389,1643,1643,0,1643,1558,85,4389,4389,0,0,4389,4338,3948,300,2,16,1,71,51,50,1,0,0,0,4389,111,4278,4389,1999,2390,3948,42,2600
42,49,2700,4056300,6854,2948,2948,0,2948,2868,80,6854,6854,0,0,6854,6795,6161,508,6,88,2,30,59,59,0,0,0,0,6854,115,6739,6854,3272,3582,6161,42,2700
42,49,2800,2852559,6810,2483,2483,0,2483,2391,92,6810,6810,0,0,6810,6750,6415,265,5,52,2,11,60,57,3,0,0,0,6810,68,6742,6810,3089,3721,6415,42,2800
42,49,2900,2529712,2916,1241,1241,0,1241,1198,43,2916,2916,0,0,2916,2904,2836,43,1,23,1,0,12,12,0,0,0,0,2916,15,2901,2916,1373,1543,2836,42,2900
42,49,3000,2184494,4218,1878,1878,0,1878,1801,77,4218,4218,0,0,4218,4166,3804,266,4,34,3,55,52,48,3,1,0,0,4218,102,4116,4218,1851,2367,3804,42,3000
42,49,10101,97628864,3378,1462,1462,0,1462,1253,209,3378,3378,0,0,3378,3352,3306,21,7,9,0,9,26,23,3,0,0,0,3378,19,3359,3378,1704,1674,3306,42,10101
42,49,10103,110378832,2010,762,762,0,762,732,30,2010,2010,0,0,2010,1995,1966,13,11,3,0,2,15,15,0,0,0,0,2010,14,1996,2010,1030,980,1966,42,10103
42,49,10104,92333418,2400,921,921,0,921,869,52,2400,2400,0,0,2400,2379,2363,5,4,2,0,5,21,16,4,1,0,0,2400,14,2386,2400,1212,1188,2363,42,10104
42,49,10107,2755042,1607,695,695,0,695,655,40,1607,1607,0,0,1607,1602,1581,8,5,6,0,2,5,5,0,0,0,0,1607,19,1588,1607,749,858,1581,42,10107
42,49,10109,1799901,1898,9,9,0,9,8,1,1898,1898,0,0,1898,1895,902,975,7,11,0,0,3,3,0,0,0,0,1898,188,1710,1898,1891,7,902,42,10109
42,49,10201,10745842,5975,2345,2345,0,2345,2251,94,5975,5975,0,0,5975,5957,5915,12,9,10,0,11,18,15,3,0,0,0,5975,36,5939,5975,2847,3128,5915,42,10201
42,49,10202,90809844,5607,2257,2257,0,2257,2127,130,5607,5607,0,0,5607,5581,5542,12,8,10,2,7,26,26,0,0,0,0,5607,19,5588,5607,2781,2826,5542,42,10202
42,49,10301,96324207,5008,1875,1875,0,1875,1799,76,5008,5008,0,0,5008,4986,4923,27,18,5,0,13,22,21,1,0,0,0,5008,35,4973,5008,2514,2494,4923,42,10301
42,49,10303,55954389,5269,1946,1946,0,1946,1859,87,5269,5269,0,0,5269,5238,5197,22,4,9,0,6,31,30,1,0,0,0,5269,38,5231,5269,2498,2771,5197,42,10303
42,49,10304,19574574,4871,1765,1765,0,1765,1676,89,4871,4871,0,0,4871,4848,4756,32,4,48,0,8,23,23,0,0,0,0,4871,31,4840,4871,2352,2519,4756,42,10304
42,49,10400,7643593,5170,2152,2152,0,2152,2025,127,5170,5170,0,0,5170,5143,5038,24,10,57,0,14,27,27,0,0,0,0,5170,65,5105,5170,2495,2675,5038,42,10400
42,49,10500,4553953,4760,2473,2473,0,2473,2216,257,4760,4760,0,0,4760,4736,4653,36,9,17,0,21,24,23,1,0,0,0,4760,60,4700,4760,2277,2483,4653,42,10500
42,49,10600,10924867,1547,840,840,0,840,756,84,1547,1547,0,0,1547,1539,1482,17,2,20,0,18,8,6,2,0,0,0,1547,26,1521,1547,703,844,1482,42,10600
42,49,10700,2757395,4163,1864,1864,0,1864,1788,76,4163,4163,0,0,4163,4123,4017,50,1,48,0,7,40,40,0,0,0,0,4163,64,4099,4163,2016,2147,4017,42,10700
42,49,10800,3966201,3700,1570,1570,0,1570,1509,61,3700,3700,0,0,3700,3681,3626,18,4,20,1,12,19,18,1,0,0,0,3700,36,3664,3700,1818,1882,3626,42,10800
42,49,10902,5042552,4451,1928,1928,0,1928,1819,109,4451,4451,0,0,4451,4418,4299,49,3,51,1,15,33,25,1,2,5,0,4451,55,4396,4451,2129,2322,4299,42,10902
42,49,10903,9085988,6237,2426,2426,0,2426,2330,96,6237,6237,0,0,6237,6193,5939,57,1,189,0,7,44,41,3,0,0,0,6237,34,6203,6237,3060,3177,5939,42,10903
42,49,10904,11449933,3289,1152,1152,0,1152,1094,58,3289,3289,0,0,3289,3280,3211,15,1,51,0,2,9,9,0,0,0,0,3289,14,3275,3289,1646,1643,3211,42,10904
42,49,11001,5230276,6753,3091,3091,0,3091,2984,107,6753,6753,0,0,6753,6717,6451,133,3,94,5,31,36,33,3,0,0,0,6753,70,6683,6753,3339,3414,6451,42,11001
42,49,11002,6381568,3707,1704,1704,0,1704,1631,73,3707,3707,0,0,3707,3689,3599,31,5,45,0,9,18,17,1,0,0,0,3707,20,3687,3707,1698,2009,3599,42,11002
42,49,11101,9031871,4900,1887,1887,0,1887,1811,76,4900,4900,0,0,4900,4851,4677,72,2,83,0,17,49,47,2,0,0,0,4900,54,4846,4900,2385,2515,4677,42,11101
42,49,11102,7910863,3481,1316,1316,0,1316,1270,46,3481,3481,0,0,3481,3465,3367,69,4,23,0,2,16,16,0,0,0,0,3481,21,3460,3481,1591,1890,3367,42,11102
42,49,11201,97202058,4768,1784,1784,0,1784,1724,60,4768,4768,0,0,4768,4753,4729,4,9,3,0,8,15,9,6,0,0,0,4768,12,4756,4768,2426,2342,4729,42,11201
42,49,11202,61841950,5529,2212,2212,0,2212,2110,102,5529,5529,0,0,5529,5496,5432,31,7,13,0,13,33,28,5,0,0,0,5529,19,5510,5529,2749,2780,5432,42,11202
42,49,11300,1384700,3617,1512,1512,0,1512,1441,71,3617,3617,0,0,3617,3574,3498,39,10,8,1,18,43,41,2,0,0,0,3617,61,3556,3617,1805,1812,3498,42,11300
42,49,11400,4816476,4048,1626,1626,0,1626,1547,79,4048,4048,0,0,4048,4032,3994,21,1,9,0,7,16,16,0,0,0,0,4048,33,4015,4048,1876,2172,3994,42,11400
42,49,11503,5855515,3851,1483,1483,0,1483,1432,51,3851,3851,0,0,3851,3834,3743,57,3,24,0,7,17,17,0,0,0,0,3851,12,3839,3851,1755,2096,3743,42,11503
42,49,11504,6764987,4776,1810,1810,0,1810,1732,78,4776,4776,0,0,4776,4758,4672,52,4,27,0,3,18,18,0,0,0,0,4776,26,4750,4776,2451,2325,4672,42,11504
42,49,11505,21894950,2778,1104,1104,0,1104,1040,64,2778,2778,0,0,2778,2759,2716,28,1,5,0,9,19,18,1,0,0,0,2778,16,2762,2778,1360,1418,2716,42,11505
42,49,11507,46641117,2845,1021,1021,0,1021,976,45,2845,2845,0,0,2845,2832,2814,10,3,1,0,4,13,12,1,0,0,0,2845,20,2825,2845,1410,1435,2814,42,11507
42,49,11508,7542674,928,227,227,0,227,218,9,928,928,0,0,928,920,857,36,1,21,2,3,8,8,0,0,0,0,928,12,916,928,529,399,857,42,11508
42,49,11600,3389840,4601,1795,1795,0,1795,1730,65,4601,4601,0,0,4601,4565,4493,37,4,4,0,27,36,35,1,0,0,0,4601,86,4515,4601,2235,2366,4493,42,11600
42,49,11701,37689775,2962,1393,1393,0,1393,1237,156,2962,2962,0,0,2962,2953,2938,6,0,1,2,6,9,9,0,0,0,0,2962,21,2941,2962,1457,1505,2938,42,11701
42,49,11702,159626339,6649,1997,1997,0,1997,1914,83,6649,6649,0,0,6649,6598,6465,77,5,34,1,16,51,44,5,0,2,0,6649,50,6599,6649,3414,3235,6465,42,11702
42,49,11801,113707887,2655,987,987,0,987,919,68,2655,2655,0,0,2655,2645,2630,2,2,10,0,1,10,10,0,0,0,0,2655,7,2648,2655,1327,1328,2630,42,11801
42,49,11802,188744018,3363,1305,1305,0,1305,1216,89,3363,3363,0,0,3363,3336,3311,2,5,16,0,2,27,27,0,0,0,0,3363,6,3357,3363,1684,1679,3311,42,11802
42,49,11900,15797075,6834,2868,2868,0,2868,2660,208,6834,6834,0,0,6834,6768,6710,20,20,11,1,6,66,58,4,0,4,0,6834,62,6772,6834,3207,3627,6710,42,11900
42,49,12001,167763648,2803,1039,1039,0,1039,985,54,2803,2803,0,0,2803,2798,2791,2,0,0,0,5,5,5,0,0,0,0,2803,9,2794,2803,1443,1360,2791,42,12001
42,49,12002,4851727,3463,1422,1422,0,1422,1326,96,3463,3463,0,0,3463,3442,3391,5,11,26,1,8,21,18,3,0,0,0,3463,29,3434,3463,1630,1833,3391,42,12002
42,49,12100,222383831,7419,2829,2829,0,2829,2636,193,7419,7419,0,0,7419,7359,7310,27,7,6,0,9,60,60,0,0,0,0,7419,35,7384,7419,3739,3680,7310,42,12100
42,49,12201,191613067,6135,2289,2289,0,2289,2193,96,6135,6135,0,0,6135,6083,6041,16,6,11,0,9,52,46,4,2,0,0,6135,38,6097,6135,3132,3003,6041,42,12201
42,49,12202,5998886,6950,2242,2242,0,2242,2087,155,6950,6950,0,0,6950,6884,6414,309,11,112,2,36,66,61,5,0,0,0,6950,69,6881,6950,3262,3688,6414,42,12202
42,51,260100,26159696,6386,2985,2985,0,2985,2719,266,6386,6386,0,0,6386,6360,6243,86,11,13,0,7,26,26,0,0,0,0,6386,21,6365,6386,2961,3425,6243,42,260100
42,51,260200,55787847,4550,2076,2076,0,2076,1968,108,4550,4550,0,0,4550,4528,4428,86,3,9,0,2,22,22,0,0,0,0,4550,9,4541,4550,2168,2382,4428,42,260200
42,51,260300,57491947,4062,1681,1681,0,1681,1599,82,4062,4062,0,0,4062,4048,3993,50,2,2,1,0,14,14,0,0,0,0,4062,12,4050,4062,2038,2024,3993,42,260300
42,51,260401,29287808,2681,1072,1072,0,1072,1032,40,2681,2681,0,0,2681,2679,2670,2,0,7,0,0,2,2,0,0,0,0,2681,1,2680,2681,1347,1334,2670,42,260401
42,51,260402,83088886,5101,2134,2134,0,2134,1991,143,5101,5101,0,0,5101,5088,5062,2,7,6,3,8,13,13,0,0,0,0,5101,12,5089,5101,2597,2504,5062,42,260402
42,51,260500,252754262,6827,3028,3028,0,3028,2544,484,6827,6827,0,0,6827,6783,6770,0,8,4,0,1,44,42,2,0,0,0,6827,34,6793,6827,3431,3396,6770,42,260500
42,51,260600,32625616,4782,2050,2050,0,2050,1930,120,4782,4782,0,0,4782,4764,4712,46,1,2,0,3,18,18,0,0,0,0,4782,10,4772,4782,2339,2443,4712,42,260600
42,51,260700,2453881,4376,2024,2024,0,2024,1823,201,4376,4376,0,0,4376,4337,4141,175,8,7,0,6,39,37,2,0,0,0,4376,18,4358,4376,2008,2368,4141,42,260700
42,51,260800,2785851,4752,2401,2401,0,2401,2132,269,4752,4752,0,0,4752,4709,4488,184,4,23,0,10,43,38,5,0,0,0,4752,31,4721,4752,2234,2518,4488,42,260800
42,51,260900,51607403,4705,1973,1973,0,1973,1853,120,4705,4705,0,0,4705,4687,4573,94,5,12,0,3,18,16,2,0,0,0,4705,12,4693,4705,2280,2425,4573,42,260900
42,51,261000,76730748,2628,1072,1072,0,1072,1012,60,2628,2628,0,0,2628,2617,2582,23,4,1,0,7,11,10,1,0,0,0,2628,3,2625,2628,1299,1329,2582,42,261000
42,51,261100,53887726,2810,1132,1132,0,1132,1087,45,2810,2810,0,0,2810,2796,2753,36,1,5,0,1,14,13,1,0,0,0,2810,13,2797,2810,1380,1430,2753,42,261100
42,51,261200,2596862,2804,1550,1550,0,1550,1238,312,2804,2804,0,0,2804,2741,2410,320,3,2,0,6,63,63,0,0,0,0,2804,23,2781,2804,1273,1531,2410,42,261200
42,51,261300,80864682,5452,2405,2405,0,2405,2222,183,5452,5452,0,0,5452,5393,5171,206,5,6,0,5,59,58,1,0,0,0,5452,20,5432,5452,2577,2875,5171,42,261300
42,51,261400,58524138,6397,2943,2943,0,2943,2651,292,6397,6397,0,0,6397,6322,5771,515,7,7,3,19,75,72,3,0,0,0,6397,19,6378,6397,3027,3370,5771,42,261400
42,51,261500,55029487,4644,1964,1964,0,1964,1810,154,4644,4644,0,0,4644,4604,4448,145,6,5,0,0,40,38,2,0,0,0,4644,16,4628,4644,2202,2442,4448,42,261500
42,51,261600,27502254,3127,1358,1358,0,1358,1260,98,3127,3127,0,0,3127,3119,3098,8,5,8,0,0,8,6,1,0,1,0,3127,11,3116,3127,1527,1600,3098,42,261600
42,51,261700,8924697,3317,1506,1506,0,1506,1359,147,3317,3317,0,0,3317,3287,3056,204,5,15,1,6,30,30,0,0,0,0,3317,14,3303,3317,1505,1812,3056,42,261700
42,51,261800,10095419,4052,1893,1893,0,1893,1794,99,4052,4052,0,0,4052,4038,3901,120,3,6,1,7,14,14,0,0,0,0,4052,16,4036,4052,1885,2167,3901,42,261800
42,51,261900,1601774,4057,2203,2203,0,2203,1828,375,4057,4057,0,0,4057,4017,3665,331,5,5,2,9,40,39,1,0,0,0,4057,29,4028,4057,1943,2114,3665,42,261900
42,51,262000,16620813,5210,2063,2063,0,2063,1986,77,5210,5210,0,0,5210,5171,4992,88,3,83,1,4,39,33,6,0,0,0,5210,16,5194,5210,2363,2847,4992,42,262000
42,51,262100,2491673,2830,1241,1241,0,1241,1167,74,2830,2830,0,0,2830,2802,2606,188,1,2,0,5,28,27,1,0,0,0,2830,15,2815,2830,1266,1564,2606,42,262100
42,51,262200,1873667,3973,2067,2067,0,2067,1832,235,3973,3973,0,0,3973,3935,3732,153,0,42,1,7,38,38,0,0,0,0,3973,12,3961,3973,1815,2158,3732,42,262200
42,51,262300,1799730,4392,2050,2050,0,2050,1763,287,4392,4392,0,0,4392,4290,3058,1202,7,3,1,19,102,88,13,0,1,0,4392,27,4365,4392,1994,2398,3058,42,262300
42,51,262400,24232100,3297,1491,1491,0,1491,1410,81,3297,3297,0,0,3297,3272,3160,95,4,10,0,3,25,19,6,0,0,0,3297,6,3291,3297,1584,1713,3160,42,262400
42,51,262500,53702117,3644,1477,1477,0,1477,1392,85,3644,3644,0,0,3644,3617,3564,36,4,11,0,2,27,27,0,0,0,0,3644,19,3625,3644,1783,1861,3564,42,262500
42,51,262600,98646092,3454,1503,1503,0,1503,1367,136,3454,3454,0,0,3454,3438,3412,19,2,5,0,0,16,16,0,0,0,0,3454,12,3442,3454,1689,1765,3412,42,262600
42,51,262700,503793032,7231,3543,3543,0,3543,2503,1040,7231,7231,0,0,7231,7209,7175,10,8,7,1,8,22,20,2,0,0,0,7231,28,7203,7231,3597,3634,7175,42,262700
42,51,262800,94136936,7339,3018,3018,0,3018,2842,176,7339,7339,0,0,7339,7268,7132,124,8,2,0,2,71,70,1,0,0,0,7339,22,7317,7339,3552,3787,7132,42,262800
42,51,262900,86327501,5595,2333,2333,0,2333,2148,185,5595,5595,0,0,5595,5562,5139,403,11,4,0,5,33,32,1,0,0,0,5595,25,5570,5595,2679,2916,5139,42,262900
42,51,263000,3935265,3611,1701,1701,0,1701,1536,165,3611,3611,0,0,3611,3590,3368,202,8,1,0,11,21,21,0,0,0,0,3611,8,3603,3611,1639,1972,3368,42,263000
42,51,263100,144483194,6296,2729,2729,0,2729,2466,263,6296,6296,0,0,6296,6248,6189,36,12,5,2,4,48,40,8,0,0,0,6296,42,6254,6296,3098,3198,6189,42,263100
42,51,263200,34979329,2441,1047,1047,0,1047,980,67,2441,2441,0,0,2441,2429,2415,6,4,3,1,0,12,12,0,0,0,0,2441,8,2433,2441,1164,1277,2415,42,263200
42,51,263300,9626383,1821,777,777,0,777,725,52,1821,1821,0,0,1821,1811,1780,28,3,0,0,0,10,10,0,0,0,0,1821,0,1821,1821,892,929,1780,42,263300
42,53,980100,535255243,2027,3080,3080,0,3080,734,2346,2027,2027,0,0,2027,2015,1862,107,9,4,0,33,12,12,0,0,0,0,2027,49,1978,2027,1124,903,1862,42,980100
42,53,980200,573562111,2919,5621,5621,0,5621,1266,4355,2919,2919,0,0,2919,2901,2883,3,11,3,0,1,18,18,0,0,0,0,2919,11,2908,2919,1480,1439,2883,42,980200
42,55,10100,292394385,4091,1827,1827,0,1827,1487,340,4091,4091,0,0,4091,4085,4045,22,0,7,0,11,6,6,0,0,0,0,4091,17,4074,4091,2029,2062,4045,42,10100
42,55,10200,266985134,4088,1578,1578,0,1578,1493,85,4088,4088,0,0,4088,4076,4023,30,3,6,1,13,12,12,0,0,0,0,4088,22,4066,4088,2096,1992,4023,42,10200
42,55,10300,100403075,7488,2953,2953,0,2953,2832,121,7488,7488,0,0,7488,7424,7249,115,8,38,2,12,64,62,1,1,0,0,7488,46,7442,7488,3604,3884,7249,42,10300
42,55,10400,60443861,6749,2940,2940,0,2940,2808,132,6749,6749,0,0,6749,6695,6491,101,5,56,7,35,54,51,3,0,0,0,6749,112,6637,6749,3253,3496,6491,42,10400
42,55,10500,86550872,5535,2369,2369,0,2369,2214,155,5535,5535,0,0,5535,5500,5350,88,5,31,5,21,35,33,2,0,0,0,5535,49,5486,5535,2712,2823,5350,42,10500
42,55,10600,21088807,6075,2294,2294,0,2294,2212,82,6075,6075,0,0,6075,5977,5705,172,17,54,1,28,98,96,1,1,0,0,6075,93,5982,6075,3037,3038,5705,42,10600
42,55,10700,115041806,7025,2836,2836,0,2836,2732,104,7025,7025,0,0,7025,6968,6860,60,10,21,0,17,57,54,3,0,0,0,7025,71,6954,7025,3498,3527,6860,42,10700
42,55,10800,3828453,3727,1894,1894,0,1894,1808,86,3727,3727,0,0,3727,3689,3475,105,5,53,0,51,38,37,1,0,0,0,3727,118,3609,3727,1647,2080,3475,42,10800
42,55,10900,5124474,3963,1853,1853,0,1853,1726,127,3963,3963,0,0,3963,3903,3440,313,6,13,2,129,60,57,3,0,0,0,3963,228,3735,3963,1865,2098,3440,42,10900
42,55,11000,4426564,3701,1773,1773,0,1773,1575,198,3701,3701,0,0,3701,3592,2620,627,15,40,5,285,109,102,5,2,0,0,3701,563,3138,3701,1741,1960,2620,42,11000
42,55,11100,2623144,3727,1514,1514,0,1514,1438,76,3727,3727,0,0,3727,3674,3486,125,3,27,2,31,53,52,1,0,0,0,3727,79,3648,3727,1488,2239,3486,42,11100
42,55,11200,1781913,2744,1271,1271,0,1271,1175,96,2744,2744,0,0,2744,2678,2418,180,4,22,0,54,66,62,4,0,0,0,2744,152,2592,2744,1293,1451,2418,42,11200
42,55,11300,92418647,8949,3612,3612,0,3612,3476,136,8949,8949,0,0,8949,8857,8499,230,10,66,7,45,92,81,11,0,0,0,8949,127,8822,8949,4363,4586,8499,42,11300
42,55,11400,133918367,5775,2292,2292,0,2292,2141,151,5775,5775,0,0,5775,5740,5657,38,15,16,0,14,35,32,3,0,0,0,5775,43,5732,5775,2920,2855,5657,42,11400
42,55,11500,147264442,5791,2488,2488,0,2488,2308,180,5791,5791,0,0,5791,5760,5576,138,2,14,0,30,31,31,0,0,0,0,5791,77,5714,5791,2822,2969,5576,42,11500
42,55,11600,252885714,5283,1997,1997,0,1997,1913,84,5283,5283,0,0,5283,5270,5239,13,6,3,0,9,13,13,0,0,0,0,5283,24,5259,5283,2763,2520,5239,42,11600
42,55,11700,90079434,6474,2383,2383,0,2383,2305,78,6474,6474,0,0,6474,6428,6317,44,24,20,0,23,46,41,5,0,0,0,6474,50,6424,6474,3218,3256,6317,42,11700
42,55,11800,4065683,3722,1748,1748,0,1748,1661,87,3722,3722,0,0,3722,3695,3600,50,7,23,2,13,27,26,1,0,0,0,3722,36,3686,3722,1799,1923,3600,42,11800
42,55,11900,91355143,6030,2215,2215,0,2215,2167,48,6030,6030,0,0,6030,6009,5926,53,7,16,0,7,21,19,2,0,0,0,6030,48,5982,6030,3000,3030,5926,42,11900
42,55,12000,117144555,7203,2493,2493,0,2493,2357,136,7203,7203,0,0,7203,7162,6929,143,9,39,1,41,41,31,7,3,0,0,7203,72,7131,7203,3589,3614,6929,42,12000
42,55,12100,36891505,3044,1248,1248,0,1248,1182,66,3044,3044,0,0,3044,3028,2962,21,2,31,1,11,16,14,2,0,0,0,3044,22,3022,3044,1479,1565,2962,42,12100
42,55,12200,2431035,3232,1581,1581,0,1581,1448,133,3232,3232,0,0,3232,3211,3122,60,2,10,1,16,21,21,0,0,0,0,3232,42,3190,3232,1530,1702,3122,42,12200
42,55,12300,2642589,3766,1821,1821,0,1821,1666,155,3766,3766,0,0,3766,3716,3501,163,11,19,0,22,50,47,3,0,0,0,3766,57,3709,3766,1699,2067,3501,42,12300
42,55,12400,3620665,2616,1231,1231,0,1231,1114,117,2616,2616,0,0,2616,2593,2530,29,1,19,0,14,23,19,1,0,3,0,2616,49,2567,2616,1274,1342,2530,42,12400
42,55,12501,47659282,5021,2022,2022,0,2022,1947,75,5021,5021,0,0,5021,5003,4886,48,6,49,0,14,18,17,1,0,0,0,5021,32,4989,5021,2453,2568,4886,42,12501
42,55,12502,16182652,3494,1570,1570,0,1570,1448,122,3494,3494,0,0,3494,3471,3373,48,9,24,3,14,23,23,0,0,0,0,3494,39,3455,3494,1743,1751,3373,42,12502
42,57,990100,195523372,4543,2197,2197,0,2197,1875,322,4543,4543,0,0,4543,4495,4390,81,14,7,2,1,48,46,2,0,0,0,4543,27,4516,4543,2226,2317,4390,42,990100
42,57,990200,534602328,5325,2582,2582,0,2582,2087,495,5325,5325,0,0,5325,5291,5268,7,10,4,0,2,34,34,0,0,0,0,5325,14,5311,5325,2656,2669,5268,42,990200
42,57,990300,403164063,4393,2011,2011,0,2011,1698,313,4393,4393,0,0,4393,4372,4354,6,5,4,0,3,21,21,0,0,0,0,4393,11,4382,4393,2251,2142,4354,42,990300
42,59,970100,99497527,7120,3148,3148,0,3148,2891,257,7120,7120,0,0,7120,7052,7017,18,15,1,0,1,68,57,9,2,0,0,7120,34,7086,7120,3430,3690,7017,42,970100
42,59,970200,58532720,3308,1424,1424,0,1424,1334,90,3308,3308,0,0,3308,3293,3204,74,8,7,0,0,15,14,1,0,0,0,3308,14,3294,3308,1570,1738,3204,42,970200
42,59,970300,226432592,4980,2017,2017,0,2017,1850,167,4980,4980,0,0,4980,4956,4909,29,9,3,5,1,24,24,0,0,0,0,4980,15,4965,4980,2505,2475,4909,42,970300
42,59,970400,562214601,4877,2218,2218,0,2218,1837,381,4877,4877,0,0,4877,4836,4826,3,5,0,1,1,41,38,2,1,0,0,4877,12,4865,4877,2441,2436,4826,42,970400
42,59,970500,235054318,8893,2814,2814,0,2814,2620,194,8893,8893,0,0,8893,8855,7417,1376,9,42,1,10,38,38,0,0,0,0,8893,213,8680,8893,5312,3581,7417,42,970500
42,59,970600,2150716,4184,1811,1811,0,1811,1619,192,4184,4184,0,0,4184,4161,4056,68,4,24,2,7,23,23,0,0,0,0,4184,27,4157,4184,2066,2118,4056,42,970600
42,59,970700,180577940,2943,1307,1307,0,1307,1148,159,2943,2943,0,0,2943,2929,2914,6,8,1,0,0,14,13,1,0,0,0,2943,17,2926,2943,1453,1490,2914,42,970700
42,59,970800,127011616,4367,1939,1939,0,1939,1761,178,4367,4367,0,0,4367,4346,4322,11,3,9,0,1,21,20,1,0,0,0,4367,25,4342,4367,2174,2193,4322,42,970800
42,61,950100,307741928,1856,1161,1161,0,1161,723,438,1856,1856,0,0,1856,1846,1837,4,0,1,0,4,10,10,0,0,0,0,1856,3,1853,1856,939,917,1837,42,950100
42,61,950200,291455660,3380,1537,1537,0,1537,1299,238,3380,3380,0,0,3380,3377,3351,3,2,3,0,18,3,3,0,0,0,0,3380,21,3359,3380,1691,1689,3351,42,950200
42,61,950300,166311030,7942,2175,2175,0,2175,1968,207,7942,7942,0,0,7942,7843,5799,1880,10,19,4,131,99,98,1,0,0,0,7942,321,7621,7942,5463,2479,5799,42,950300
42,61,950400,8931070,6918,2817,2817,0,2817,2626,191,6918,6918,0,0,6918,6841,6669,97,12,42,0,21,77,77,0,0,0,0,6918,46,6872,6918,3167,3751,6669,42,950400
42,61,950500,195003596,3487,1652,1652,0,1652,1363,289,3487,3487,0,0,3487,3470,3435,18,2,14,0,1,17,16,1,0,0,0,3487,10,3477,3487,1727,1760,3435,42,950500
42,61,950600,215734888,3889,2155,2155,0,2155,1538,617,3889,3889,0,0,3889,3872,3845,10,4,4,0,9,17,17,0,0,0,0,3889,11,3878,3889,1939,1950,3845,42,950600
42,61,950800,304103089,3696,2102,2102,0,2102,1401,701,3696,3696,0,0,3696,3674,3648,18,3,0,0,5,22,20,2,0,0,0,3696,27,3669,3696,1858,1838,3648,42,950800
42,61,950900,2919168,2504,1288,1288,0,1288,1166,122,2504,2504,0,0,2504,2451,2166,276,1,0,0,8,53,50,3,0,0,0,2504,30,2474,2504,1124,1380,2166,42,950900
42,61,951000,151198344,2666,1336,1336,0,1336,1049,287,2666,2666,0,0,2666,2654,2625,16,5,7,0,1,12,12,0,0,0,0,2666,19,2647,2666,1318,1348,2625,42,951000
42,61,951100,205436870,2025,993,993,0,993,754,239,2025,2025,0,0,2025,2016,2007,6,2,0,0,1,9,9,0,0,0,0,2025,9,2016,2025,1031,994,2007,42,951100
42,61,951200,282072275,4791,2552,2552,0,2552,1897,655,4791,4791,0,0,4791,4769,4751,10,2,2,0,4,22,22,0,0,0,0,4791,16,4775,4791,2346,2445,4751,42,951200
42,61,951300,132883402,2432,1290,1290,0,1290,975,315,2432,2432,0,0,2432,2424,2411,4,5,2,0,2,8,8,0,0,0,0,2432,11,2421,2432,1239,1193,2411,42,951300
42,63,960100,228511296,4356,1793,1793,0,1793,1533,260,4356,4356,0,0,4356,4332,4319,4,1,4,0,4,24,23,1,0,0,0,4356,11,4345,4356,2202,2154,4319,42,960100
42,63,960200,234981009,5018,1871,1871,0,1871,1637,234,5018,5018,0,0,5018,5009,4976,8,4,13,4,4,9,9,0,0,0,0,5018,0,5018,5018,2508,2510,4976,42,960200
42,63,960300,145520360,2845,1205,1205,0,1205,1029,176,2845,2845,0,0,2845,2831,2822,5,3,1,0,0,14,14,0,0,0,0,2845,10,2835,2845,1398,1447,2822,42,960300
42,63,960400,136656451,3995,1577,1577,0,1577,1431,146,3995,3995,0,0,3995,3960,3949,7,0,0,0,4,35,34,1,0,0,0,3995,21,3974,3995,1989,2006,3949,42,960400
42,63,960500,122872870,3793,1539,1539,0,1539,1428,111,3793,3793,0,0,3793,3777,3753,13,3,6,0,2,16,15,1,0,0,0,3793,12,3781,3793,1908,1885,3753,42,960500
42,63,960600,197577470,5345,2154,2154,0,2154,2022,132,5345,5345,0,0,5345,5315,5275,20,1,10,0,9,30,29,1,0,0,0,5345,23,5322,5345,2666,2679,5275,42,960600
42,63,960700,22342893,6200,2961,2961,0,2961,2754,207,6200,6200,0,0,6200,6128,5713,172,9,215,0,19,72,71,1,0,0,0,6200,59,6141,6200,2859,3341,5713,42,960700
42,63,960800,44824894,3910,1628,1628,0,1628,1534,94,3910,3910,0,0,3910,3893,3796,37,4,52,0,4,17,16,1,0,0,0,3910,22,3888,3910,1846,2064,3796,42,960800
42,63,960900,43098427,3924,1964,1964,0,1964,1737,227,3924,3924,0,0,3924,3895,3707,139,3,34,0,12,29,28,1,0,0,0,3924,16,3908,3924,1880,2044,3707,42,960900
42,63,961000,1298875,2355,1057,1057,0,1057,988,69,2355,2355,0,0,2355,2339,2270,44,4,16,1,4,16,16,0,0,0,0,2355,19,2336,2355,1210,1145,2270,42,961000
42,63,961101,1465119,4893,2209,2209,0,2209,2081,128,4893,4893,0,0,4893,4852,4575,161,1,101,1,13,41,36,5,0,0,0,4893,46,4847,4893,2145,2748,4575,42,961101
42,63,961102,505960,5078,598,598,0,598,580,18,5078,5078,0,0,5078,5028,4350,522,3,115,1,37,50,49,1,0,0,0,5078,83,4995,5078,2191,2887,4350,42,961102
42,63,961200,1300874,2569,1232,1232,0,1232,1155,77,2569,2569,0,0,2569,2543,2435,46,2,49,0,11,26,25,1,0,0,0,2569,30,2539,2569,1246,1323,2435,42,961200
42,63,961300,127952342,4389,1833,1833,0,1833,1677,156,4389,4389,0,0,4389,4376,4351,14,5,5,0,1,13,13,0,0,0,0,4389,6,4383,4389,2140,2249,4351,42,961300
42,63,961400,159327845,3415,1411,1411,0,1411,1284,127,3415,3415,0,0,3415,3399,3390,3,6,0,0,0,16,16,0,0,0,0,3415,9,3406,3415,1715,1700,3390,42,961400
42,63,961500,189365856,4256,1768,1768,0,1768,1598,170,4256,4256,0,0,4256,4245,4231,4,2,6,0,2,11,11,0,0,0,0,4256,16,4240,4256,2176,2080,4231,42,961500
42,63,961600,104576930,4876,2132,2132,0,2132,2024,108,4876,4876,0,0,4876,4865,4825,25,5,6,0,4,11,11,0,0,0,0,4876,22,4854,4876,2417,2459,4825,42,961600
42,63,961700,1448000,1844,869,869,0,869,805,64,1844,1844,0,0,1844,1838,1833,4,0,1,0,0,6,6,0,0,0,0,1844,6,1838,1844,858,986,1833,42,961700
42,63,961800,90223560,1744,805,805,0,805,741,64,1744,1744,0,0,1744,1736,1724,8,3,1,0,0,8,8,0,0,0,0,1744,0,1744,1744,845,899,1724,42,961800
42,63,961900,159184690,4709,2008,2008,0,2008,1879,129,4709,4709,0,0,4709,4687,4672,3,2,6,0,4,22,21,1,0,0,0,4709,18,4691,4709,2326,2383,4672,42,961900
42,63,962000,61428107,3746,1632,1632,0,1632,1495,137,3746,3746,0,0,3746,3732,3665,59,3,1,0,4,14,14,0,0,0,0,3746,17,3729,3746,1834,1912,3665,42,962000
42,63,962100,3605242,3607,1830,1830,0,1830,1631,199,3607,3607,0,0,3607,3586,3451,108,4,21,0,2,21,19,2,0,0,0,3607,2,3605,3607,1697,1910,3451,42,962100
42,63,962200,69734039,2738,1174,1174,0,1174,1080,94,2738,2738,0,0,2738,2723,2714,1,3,2,1,2,15,15,0,0,0,0,2738,9,2729,2738,1366,1372,2714,42,962200
42,65,950100,3006792,2182,994,994,0,994,911,83,2182,2182,0,0,2182,2180,2175,0,1,4,0,0,2,2,0,0,0,0,2182,2,2180,2182,1037,1145,2175,42,950100
42,65,950200,299358068,3158,2537,2537,0,2537,1249,1288,3158,3158,0,0,3158,3137,3119,6,6,4,0,2,21,21,0,0,0,0,3158,19,3139,3158,1605,1553,3119,42,950200
42,65,950300,378968473,5493,2869,2869,0,2869,2157,712,5493,5493,0,0,5493,5465,5437,6,13,8,1,0,28,27,0,1,0,0,5493,19,5474,5493,2783,2710,5437,42,950300
42,65,950400,4342029,2059,1003,1003,0,1003,944,59,2059,2059,0,0,2059,2048,2005,10,3,26,0,4,11,11,0,0,0,0,2059,13,2046,2059,954,1105,2005,42,950400
42,65,950500,4004534,2171,973,973,0,973,905,68,2171,2171,0,0,2171,2161,2155,1,1,4,0,0,10,10,0,0,0,0,2171,7,2164,2171,975,1196,2155,42,950500
42,65,950600,295037410,5826,2522,2522,0,2522,2179,343,5826,5826,0,0,5826,5791,5765,5,3,10,0,8,35,35,0,0,0,0,5826,9,5817,5826,2910,2916,5765,42,950600
42,65,950700,3744996,2710,1233,1233,0,1233,1117,116,2710,2710,0,0,2710,2696,2679,4,10,3,0,0,14,11,3,0,0,0,2710,15,2695,2710,1301,1409,2679,42,950700
42,65,950800,121879027,3837,1718,1718,0,1718,1544,174,3837,3837,0,0,3837,3833,3816,5,6,5,0,1,4,4,0,0,0,0,3837,18,3819,3837,1914,1923,3816,42,950800
42,65,950900,307157183,4244,1883,1883,0,1883,1640,243,4244,4244,0,0,4244,4229,4199,4,11,8,0,7,15,11,4,0,0,0,4244,15,4229,4244,2188,2056,4199,42,950900
42,65,951000,182634676,4152,1700,1700,0,1700,1483,217,4152,4152,0,0,4152,4133,4109,3,9,1,4,7,19,19,0,0,0,0,4152,14,4138,4152,2089,2063,4109,42,951000
42,65,951100,88705933,3829,1630,1630,0,1630,1498,132,3829,3829,0,0,3829,3815,3803,1,2,7,0,2,14,14,0,0,0,0,3829,10,3819,3829,1905,1924,3803,42,951100
42,65,951200,4067636,3365,1611,1611,0,1611,1469,142,3365,3365,0,0,3365,3335,3304,11,6,14,0,0,30,30,0,0,0,0,3365,32,3333,3365,1516,1849,3304,42,951200
42,65,951300,4777836,2906,1431,1431,0,1431,1279,152,2906,2906,0,0,2906,2902,2891,3,4,3,0,1,4,4,0,0,0,0,2906,15,2891,2906,1288,1618,2891,42,951300
42,67,970100,186451448,6657,2865,2865,0,2865,2562,303,6657,6657,0,0,6657,6639,6536,19,4,22,37,21,18,17,0,0,1,0,6657,112,6545,6657,3248,3409,6536,42,970100
42,67,970200,531125252,7540,3724,3724,0,3724,2889,835,7540,7540,0,0,7540,7477,7303,39,22,25,2,86,63,58,4,1,0,0,7540,225,7315,7540,3791,3749,7303,42,970200
42,67,970300,152147138,4773,2010,2010,0,2010,1824,186,4773,4773,0,0,4773,4762,4731,13,4,8,0,6,11,11,0,0,0,0,4773,20,4753,4773,2369,2404,4731,42,970300
42,67,970400,144496918,3851,1432,1432,0,1432,1309,123,3851,3851,0,0,3851,3826,3806,14,2,2,0,2,25,22,2,1,0,0,3851,12,3839,3851,1945,1906,3806,42,970400
42,69,100200,932713,2597,1536,1536,0,1536,1231,305,2597,2597,0,0,2597,2535,2017,324,3,149,4,38,62,57,3,2,0,0,2597,137,2460,2597,1320,1277,2017,42,100200
42,69,100300,712280,3962,1052,1052,0,1052,849,203,3962,3962,0,0,3962,3917,3594,146,3,106,0,68,45,43,2,0,0,0,3962,145,3817,3962,1663,2299,3594,42,100300
42,69,100400,484491,2194,1040,1040,0,1040,883,157,2194,2194,0,0,2194,2153,1865,154,5,43,0,86,41,40,0,1,0,0,2194,119,2075,2194,1051,1143,1865,42,100400
42,69,100500,1374556,2111,991,991,0,991,920,71,2111,2111,0,0,2111,2096,2037,28,0,23,0,8,15,15,0,0,0,0,2111,34,2077,2111,976,1135,2037,42,100500
42,69,100600,1613542,4154,1974,1974,0,1974,1641,333,4154,4154,0,0,4154,4076,3591,317,10,85,0,73,78,66,12,0,0,0,4154,178,3976,4154,1993,2161,3591,42,100600
42,69,100800,681543,3036,1217,1217,0,1217,1063,154,3036,3036,0,0,3036,2993,2730,215,6,18,0,24,43,40,2,1,0,0,3036,80,2956,3036,1622,1414,2730,42,100800
42,69,100900,1228507,1637,819,819,0,819,726,93,1637,1637,0,0,1637,1614,1537,36,4,15,2,20,23,21,2,0,0,0,1637,33,1604,1637,802,835,1537,42,100900
42,69,101000,2461902,3856,1468,1468,0,1468,1352,116,3856,3856,0,0,3856,3836,3776,21,5,26,0,8,20,19,1,0,0,0,3856,20,3836,3856,1474,2382,3776,42,101000
42,69,101100,1017566,2884,1328,1328,0,1328,1181,147,2884,2884,0,0,2884,2858,2794,42,1,14,0,7,26,26,0,0,0,0,2884,27,2857,2884,1396,1488,2794,42,101100
42,69,101200,6321336,2858,1343,1343,0,1343,1215,128,2858,2858,0,0,2858,2835,2709,54,2,48,0,22,23,23,0,0,0,0,2858,59,2799,2858,1333,1525,2709,42,101200
42,69,101300,1108508,2881,1382,1382,0,1382,1221,161,2881,2881,0,0,2881,2854,2792,26,2,6,0,28,27,25,2,0,0,0,2881,58,2823,2881,1385,1496,2792,42,101300
42,69,101400,1774546,2866,1289,1289,0,1289,1120,169,2866,2866,0,0,2866,2782,2453,173,15,22,0,119,84,80,4,0,0,0,2866,289,2577,2866,1295,1571,2453,42,101400
42,69,101600,572929,2681,1280,1280,0,1280,1149,131,2681,2681,0,0,2681,2652,2616,11,1,1,0,23,29,25,4,0,0,0,2681,36,2645,2681,1286,1395,2616,42,101600
42,69,101700,1425036,3253,1488,1488,0,1488,1373,115,3253,3253,0,0,3253,3248,3219,9,0,3,3,14,5,4,1,0,0,0,3253,35,3218,3253,1504,1749,3219,42,101700
42,69,101800,10043796,3722,1698,1698,0,1698,1610,88,3722,3722,0,0,3722,3700,3639,17,1,40,0,3,22,21,1,0,0,0,3722,13,3709,3722,1738,1984,3639,42,101800
42,69,101900,1291861,1606,697,697,0,697,652,45,1606,1606,0,0,1606,1604,1567,13,0,18,0,6,2,2,0,0,0,0,1606,8,1598,1606,744,862,1567,42,101900
42,69,102000,446291,2253,1094,1094,0,1094,971,123,2253,2253,0,0,2253,2242,2202,22,0,3,0,15,11,9,2,0,0,0,2253,34,2219,2253,1059,1194,2202,42,102000
42,69,102100,651366,2463,1259,1259,0,1259,1097,162,2463,2463,0,0,2463,2444,2402,12,6,14,0,10,19,14,5,0,0,0,2463,23,2440,2463,1118,1345,2402,42,102100
42,69,102200,748846,2490,1164,1164,0,1164,1067,97,2490,2490,0,0,2490,2472,2433,29,3,5,0,2,18,18,0,0,0,0,2490,29,2461,2490,1179,1311,2433,42,102200
42,69,102300,1859523,3862,1908,1908,0,1908,1684,224,3862,3862,0,0,3862,3842,3698,62,0,38,0,44,20,20,0,0,0,0,3862,76,3786,3862,1803,2059,3698,42,102300
42,69,102500,1548489,3184,1685,1685,0,1685,1423,262,3184,3184,0,0,3184,3128,2893,134,1,41,1,58,56,52,4,0,0,0,3184,101,3083,3184,1520,1664,2893,42,102500
42,69,102600,535703,2352,1294,1294,0,1294,1120,174,2352,2352,0,0,2352,2334,2197,80,5,8,0,44,18,18,0,0,0,0,2352,129,2223,2352,1084,1268,2197,42,102600
42,69,102700,1455387,2904,1333,1333,0,1333,1247,86,2904,2904,0,0,2904,2888,2832,16,1,22,2,15,16,16,0,0,0,0,2904,40,2864,2904,1378,1526,2832,42,102700
42,69,102800,19045570,3048,1475,1475,0,1475,1360,115,3048,3048,0,0,3048,3042,2959,34,0,37,0,12,6,6,0,0,0,0,3048,20,3028,3048,1418,1630,2959,42,102800
42,69,102900,2831798,3759,1809,1809,0,1809,1571,238,3759,3759,0,0,3759,3677,3237,293,9,12,3,123,82,74,7,0,0,1,3759,220,3539,3759,1639,2120,3237,42,102900
42,69,103000,1413786,2157,1010,1010,0,1010,925,85,2157,2157,0,0,2157,2135,2070,32,1,17,0,15,22,19,3,0,0,0,2157,48,2109,2157,967,1190,2070,42,103000
42,69,103100,1752669,1645,703,703,0,703,652,51,1645,1645,0,0,1645,1640,1621,4,1,9,0,5,5,5,0,0,0,0,1645,8,1637,1645,796,849,1621,42,103100
42,69,110100,42958541,3069,1346,1346,0,1346,1237,109,3069,3069,0,0,3069,3056,3024,8,1,12,0,11,13,13,0,0,0,0,3069,20,3049,3069,1444,1625,3024,42,110100
42,69,110201,117510747,3871,2018,2018,0,2018,1489,529,3871,3871,0,0,3871,3854,3825,14,4,8,0,3,17,16,1,0,0,0,3871,16,3855,3871,1903,1968,3825,42,110201
42,69,110202,70792568,4931,2123,2123,0,2123,1841,282,4931,4931,0,0,4931,4909,4850,32,0,18,0,9,22,19,3,0,0,0,4931,35,4896,4931,2496,2435,4850,42,110202
42,69,110300,65152176,4202,1683,1683,0,1683,1591,92,4202,4202,0,0,4202,4173,4104,9,4,51,0,5,29,28,1,0,0,0,4202,37,4165,4202,2071,2131,4104,42,110300
42,69,110401,12203152,6316,2352,2352,0,2352,2281,71,6316,6316,0,0,6316,6272,6082,32,1,148,0,9,44,43,0,1,0,0,6316,58,6258,6316,3072,3244,6082,42,110401
42,69,110402,14833417,2568,1032,1032,0,1032,1000,32,2568,2568,0,0,2568,2557,2468,14,0,75,0,0,11,11,0,0,0,0,2568,22,2546,2568,1250,1318,2468,42,110402
42,69,110403,9403006,2908,897,897,0,897,847,50,2908,2908,0,0,2908,2901,2836,17,2,42,1,3,7,7,0,0,0,0,2908,23,2885,2908,1350,1558,2836,42,110403
42,69,110500,4321593,5218,2308,2308,0,2308,2223,85,5218,5218,0,0,5218,5198,5099,21,5,60,1,12,20,20,0,0,0,0,5218,50,5168,5218,2463,2755,5099,42,110500
42,69,110600,41810117,2764,1228,1228,0,1228,1155,73,2764,2764,0,0,2764,2761,2753,1,2,3,0,2,3,3,0,0,0,0,2764,14,2750,2764,1334,1430,2753,42,110600
42,69,110700,3828811,2554,1179,1179,0,1179,1093,86,2554,2554,0,0,2554,2542,2527,7,3,2,0,3,12,12,0,0,0,0,2554,16,2538,2554,1106,1448,2527,42,110700
42,69,110800,1738480,3936,1899,1899,0,1899,1650,249,3936,3936,0,0,3936,3910,3858,16,12,11,0,13,26,21,5,0,0,0,3936,75,3861,3936,1809,2127,3858,42,110800
42,69,110900,2819815,3314,1449,1449,0,1449,1341,108,3314,3314,0,0,3314,3301,3277,0,5,10,0,9,13,13,0,0,0,0,3314,31,3283,3314,1533,1781,3277,42,110900
42,69,111000,2020714,2287,1012,1012,0,1012,942,70,2287,2287,0,0,2287,2284,2252,17,5,9,0,1,3,3,0,0,0,0,2287,8,2279,2287,1103,1184,2252,42,111000
42,69,111100,43557103,6220,2594,2594,0,2594,2470,124,6220,6220,0,0,6220,6177,6136,17,10,13,0,1,43,43,0,0,0,0,6220,25,6195,6220,2984,3236,6136,42,111100
42,69,111200,10009506,7027,3010,3010,0,3010,2843,167,7027,7027,0,0,7027,6988,6909,20,3,32,0,24,39,36,3,0,0,0,7027,54,6973,7027,3154,3873,6909,42,111200
42,69,111300,17335156,4718,2073,2073,0,2073,1976,97,4718,4718,0,0,4718,4690,4657,13,0,13,1,6,28,27,1,0,0,0,4718,13,4705,4718,2193,2525,4657,42,111300
42,69,111400,13933630,4978,2381,2381,0,2381,2197,184,4978,4978,0,0,4978,4953,4903,23,1,20,2,4,25,25,0,0,0,0,4978,27,4951,4978,2328,2650,4903,42,111400
42,69,111500,2911637,3590,1625,1625,0,1625,1516,109,3590,3590,0,0,3590,3583,3563,3,2,14,0,1,7,7,0,0,0,0,3590,16,3574,3590,1719,1871,3563,42,111500
42,69,111600,9286927,2615,1288,1288,0,1288,1176,112,2615,2615,0,0,2615,2597,2569,12,2,2,0,12,18,18,0,0,0,0,2615,36,2579,2615,1192,1423,2569,42,111600
42,69,111700,13042449,4010,1813,1813,0,1813,1709,104,4010,4010,0,0,4010,3994,3969,19,0,5,0,1,16,16,0,0,0,0,4010,30,3980,4010,1914,2096,3969,42,111700
42,69,111800,154715062,7950,3173,3173,0,3173,2891,282,7950,7950,0,0,7950,7912,7853,23,3,27,0,6,38,33,5,0,0,0,7950,32,7918,7950,3907,4043,7853,42,111800
42,69,112000,6111897,4056,1788,1788,0,1788,1701,87,4056,4056,0,0,4056,4036,3997,21,1,10,2,5,20,20,0,0,0,0,4056,37,4019,4056,1857,2199,3997,42,112000
42,69,112100,14157063,4327,2111,2111,0,2111,1968,143,4327,4327,0,0,4327,4306,4245,18,2,32,0,9,21,20,1,0,0,0,4327,30,4297,4327,2058,2269,4245,42,112100
42,69,112200,880892,2760,1218,1218,0,1218,1155,63,2760,2760,0,0,2760,2757,2737,8,3,5,0,4,3,3,0,0,0,0,2760,28,2732,2760,1309,1451,2737,42,112200
42,69,112300,1489069,2875,1411,1411,0,1411,1317,94,2875,2875,0,0,2875,2868,2822,22,2,15,0,7,7,7,0,0,0,0,2875,28,2847,2875,1345,1530,2822,42,112300
42,69,112400,103719782,4128,1540,1540,0,1540,1461,79,4128,4128,0,0,4128,4125,4089,9,8,12,0,7,3,3,0,0,0,0,4128,16,4112,4128,2114,2014,4089,42,112400
42,69,112500,13524455,6475,2872,2872,0,2872,2678,194,6475,6475,0,0,6475,6460,6367,22,5,40,0,26,15,14,1,0,0,0,6475,41,6434,6475,3007,3468,6367,42,112500
42,69,112600,5811943,5810,2630,2630,0,2630,2477,153,5810,5810,0,0,5810,5796,5759,12,3,17,0,5,14,13,1,0,0,0,5810,20,5790,5810,2688,3122,5759,42,112600
42,69,112700,3135034,2988,1351,1351,0,1351,1269,82,2988,2988,0,0,2988,2977,2952,2,0,17,0,6,11,11,0,0,0,0,2988,10,2978,2988,1375,1613,2952,42,112700
42,69,112800,16723975,5575,2206,2206,0,2206,2080,126,5575,5575,0,0,5575,5559,5502,16,0,27,0,14,16,15,1,0,0,0,5575,30,5545,5575,2638,2937,5502,42,112800
42,69,112900,302774939,8840,4416,4416,0,4416,3341,1075,8840,8840,0,0,8840,8789,8696,41,11,29,0,12,51,47,4,0,0,0,8840,81,8759,8840,4355,4485,8696,42,112900
42,71,100,553022,2566,1431,1431,0,1431,1268,163,2566,2566,0,0,2566,2481,1416,386,38,30,5,606,85,79,6,0,0,0,2566,1022,1544,2566,1295,1271,1416,42,100
42,71,200,1183161,2671,1131,1131,0,1131,1048,83,2671,2671,0,0,2671,2605,1706,314,2,255,0,328,66,57,7,0,2,0,2671,651,2020,2671,1305,1366,1706,42,200
42,71,300,838325,4686,1989,1989,0,1989,1855,134,4686,4686,0,0,4686,4508,3273,513,9,158,2,553,178,159,15,3,1,0,4686,1020,3666,4686,2272,2414,3273,42,300
42,71,400,712402,4062,2134,2134,0,2134,1927,207,4062,4062,0,0,4062,3940,2862,442,26,78,3,529,122,118,3,1,0,0,4062,1027,3035,4062,1832,2230,2862,42,400
42,71,500,872040,4731,1637,1637,0,1637,1501,136,4731,4731,0,0,4731,4604,3970,277,10,188,4,155,127,121,6,0,0,0,4731,359,4372,4731,2248,2483,3970,42,500
42,71,600,506439,3176,1694,1694,0,1694,1493,201,3176,3176,0,0,3176,3072,2509,247,4,40,3,269,104,100,4,0,0,0,3176,580,2596,3176,1533,1643,2509,42,600
42,71,700,412080,3714,1272,1272,0,1272,1135,137,3714,3714,0,0,3714,3539,2141,722,9,148,3,516,175,168,7,0,0,0,3714,965,2749,3714,2146,1568,2141,42,700
42,71,800,978155,4444,1292,1292,0,1292,1200,92,4444,4444,0,0,4444,4238,1472,1050,24,97,1,1594,206,192,9,5,0,0,4444,2406,2038,4444,2115,2329,1472,42,800
42,71,900,374594,3555,1452,1452,0,1452,1280,172,3555,3555,0,0,3555,3379,1299,850,26,60,9,1135,176,161,12,2,1,0,3555,1953,1602,3555,1708,1847,1299,42,900
42,71,1000,404886,3435,1367,1367,0,1367,1196,171,3435,3435,0,0,3435,3219,1974,516,13,46,0,670,216,210,5,1,0,0,3435,1133,2302,3435,1693,1742,1974,42,1000
42,71,1100,407730,3106,1356,1356,0,1356,1255,101,3106,3106,0,0,3106,2995,2509,254,18,55,3,156,111,105,6,0,0,0,3106,459,2647,3106,1466,1640,2509,42,1100
42,71,1200,1353418,4293,1972,1972,0,1972,1889,83,4293,4293,0,0,4293,4183,3399,369,7,135,2,271,110,104,6,0,0,0,4293,605,3688,4293,2004,2289,3399,42,1200
42,71,1400,1045587,4922,1809,1809,0,1809,1559,250,4922,4922,0,0,4922,4642,2492,845,36,37,3,1229,280,271,9,0,0,0,4922,2190,2732,4922,2516,2406,2492,42,1400
42,71,1500,843795,1351,440,440,0,440,383,57,1351,1351,0,0,1351,1276,329,309,13,2,4,619,75,73,1,1,0,0,1351,875,476,1351,630,721,329,42,1500
42,71,1600,301829,2830,881,881,0,881,797,84,2830,2830,0,0,2830,2688,829,706,8,25,4,1116,142,140,2,0,0,0,2830,1903,927,2830,1386,1444,829,42,1600
42,71,10101,71442242,6967,2383,2383,0,2383,2298,85,6967,6967,0,0,6967,6933,6849,22,6,27,0,29,34,32,2,0,0,0,6967,75,6892,6967,3455,3512,6849,42,10101
42,71,10102,3383214,3332,1298,1298,0,1298,1266,32,3332,3332,0,0,3332,3308,3225,27,0,33,1,22,24,23,1,0,0,0,3332,76,3256,3332,1625,1707,3225,42,10102
42,71,10201,68733411,4683,1609,1609,0,1609,1573,36,4683,4683,0,0,4683,4666,4625,14,1,12,0,14,17,15,2,0,0,0,4683,48,4635,4683,2408,2275,4625,42,10201
42,71,10202,34386464,4323,1526,1526,0,1526,1489,37,4323,4323,0,0,4323,4282,4219,9,2,40,2,10,41,40,1,0,0,0,4323,29,4294,4323,2180,2143,4219,42,10202
42,71,10300,76731804,7312,2671,2671,0,2671,2606,65,7312,7312,0,0,7312,7278,7132,61,11,53,4,17,34,32,2,0,0,0,7312,63,7249,7312,3607,3705,7132,42,10300
42,71,10400,3626492,4784,2075,2075,0,2075,1989,86,4784,4784,0,0,4784,4723,4611,30,4,48,1,29,61,60,1,0,0,0,4784,81,4703,4784,2319,2465,4611,42,10400
42,71,10501,60323323,4268,1515,1515,0,1515,1480,35,4268,4268,0,0,4268,4240,4192,11,4,10,0,23,28,27,1,0,0,0,4268,26,4242,4268,2166,2102,4192,42,10501
42,71,10502,62793090,4310,1670,1670,0,1670,1595,75,4310,4310,0,0,4310,4287,4190,14,3,59,0,21,23,23,0,0,0,0,4310,43,4267,4310,2186,2124,4190,42,10502
42,71,10600,72310196,7923,2939,2939,0,2939,2889,50,7923,7923,0,0,7923,7873,7696,20,11,85,4,57,50,46,4,0,0,0,7923,110,7813,7923,3959,3964,7696,42,10600
42,71,10701,3194691,5754,2435,2435,0,2435,2342,93,5754,5754,0,0,5754,5698,5531,51,13,88,4,11,56,55,1,0,0,0,5754,76,5678,5754,2782,2972,5531,42,10701
42,71,10702,3647815,6154,2056,2056,0,2056,1936,120,6154,6154,0,0,6154,6106,5940,56,8,58,1,43,48,45,3,0,0,0,6154,96,6058,6154,2588,3566,5940,42,10702
42,71,10801,40314383,6539,2560,2560,0,2560,2474,86,6539,6539,0,0,6539,6498,6424,18,6,30,3,17,41,39,2,0,0,0,6539,46,6493,6539,3207,3332,6424,42,10801
42,71,10802,38441756,3067,1130,1130,0,1130,1103,27,3067,3067,0,0,3067,3055,3035,1,4,5,1,9,12,12,0,0,0,0,3067,26,3041,3067,1565,1502,3035,42,10802
42,71,10900,6073780,6765,2957,2957,0,2957,2839,118,6765,6765,0,0,6765,6694,6475,100,8,34,0,77,71,68,3,0,0,0,6765,209,6556,6765,3289,3476,6475,42,10900
42,71,11000,1941567,2689,1168,1168,0,1168,1092,76,2689,2689,0,0,2689,2667,2577,67,4,4,1,14,22,22,0,0,0,0,2689,51,2638,2689,1344,1345,2577,42,11000
42,71,11100,56504273,5405,2010,2010,0,2010,1941,69,5405,5405,0,0,5405,5365,5253,41,3,31,2,35,40,38,2,0,0,0,5405,96,5309,5405,2712,2693,5253,42,11100
42,71,11200,1068759,1913,875,875,0,875,750,125,1913,1913,0,0,1913,1858,1661,120,7,7,5,58,55,54,1,0,0,0,1913,157,1756,1913,919,994,1661,42,11200
42,71,11300,2643845,4060,1741,1741,0,1741,1670,71,4060,4060,0,0,4060,3995,3834,110,5,13,0,33,65,63,2,0,0,0,4060,108,3952,4060,1890,2170,3834,42,11300
42,71,11400,2604036,4338,1979,1979,0,1979,1867,112,4338,4338,0,0,4338,4262,3923,226,7,22,0,84,76,73,3,0,0,0,4338,198,4140,4338,2054,2284,3923,42,11400
42,71,11502,20688336,5430,2081,2081,0,2081,2010,71,5430,5430,0,0,5430,5343,4881,148,5,66,1,242,87,79,8,0,0,0,5430,449,4981,5430,2657,2773,4881,42,11502
42,71,11503,6484517,4826,1867,1867,0,1867,1842,25,4826,4826,0,0,4826,4779,4535,85,7,103,0,49,47,47,0,0,0,0,4826,166,4660,4826,2338,2488,4535,42,11503
42,71,11504,23793632,7304,2628,2628,0,2628,2586,42,7304,7304,0,0,7304,7234,7004,82,3,88,0,57,70,66,4,0,0,0,7304,142,7162,7304,3512,3792,7004,42,11504
42,71,11600,24518860,5782,2233,2233,0,2233,2169,64,5782,5782,0,0,5782,5721,5528,69,7,56,4,57,61,54,7,0,0,0,5782,138,5644,5782,2816,2966,5528,42,11600
42,71,11701,8964414,4412,1989,1989,0,1989,1923,66,4412,4412,0,0,4412,4368,4157,61,3,101,0,46,44,42,2,0,0,0,4412,104,4308,4412,2080,2332,4157,42,11701
42,71,11702,12812394,8008,3528,3528,0,3528,3423,105,8008,8008,0,0,8008,7919,7160,198,19,299,0,243,89,82,7,0,0,0,8008,388,7620,8008,3963,4045,7160,42,11702
42,71,11703,11616493,7647,2777,2777,0,2777,2745,32,7647,7647,0,0,7647,7608,7381,56,1,141,0,29,39,38,1,0,0,0,7647,92,7555,7647,3809,3838,7381,42,11703
42,71,11801,4808214,2908,1116,1116,0,1116,1083,33,2908,2908,0,0,2908,2894,2795,35,2,56,0,6,14,14,0,0,0,0,2908,32,2876,2908,1420,1488,2795,42,11801
42,71,11802,4206486,5422,2386,2386,0,2386,2320,66,5422,5422,0,0,5422,5341,5016,110,7,144,0,64,81,76,5,0,0,0,5422,158,5264,5422,2502,2920,5016,42,11802
42,71,11803,6850336,5328,2607,2607,0,2607,2465,142,5328,5328,0,0,5328,5282,5042,42,4,157,0,37,46,41,5,0,0,0,5328,122,5206,5328,2419,2909,5042,42,11803
42,71,11804,10750798,7657,2895,2895,0,2895,2841,54,7657,7657,0,0,7657,7577,7070,101,1,337,1,67,80,69,11,0,0,0,7657,198,7459,7657,3750,3907,7070,42,11804
42,71,11805,8190770,2370,824,824,0,824,778,46,2370,2370,0,0,2370,2325,2006,94,10,97,0,118,45,36,9,0,0,0,2370,205,2165,2370,1057,1313,2006,42,11805
42,71,11900,31858475,9953,3593,3593,0,3593,3466,127,9953,9953,0,0,9953,9849,9401,124,11,252,1,60,104,101,3,0,0,0,9953,221,9732,9953,4608,5345,9401,42,11900
42,71,12001,2976630,5155,2189,2189,0,2189,2142,47,5155,5155,0,0,5155,5121,5015,24,2,48,3,29,34,32,2,0,0,0,5155,82,5073,5155,2357,2798,5015,42,12001
42,71,12002,3044271,3874,1638,1638,0,1638,1590,48,3874,3874,0,0,3874,3833,3764,16,6,31,0,16,41,40,1,0,0,0,3874,55,3819,3874,1827,2047,3764,42,12002
42,71,12101,29076700,8376,3018,3018,0,3018,2942,76,8376,8376,0,0,8376,8294,8146,51,8,50,6,33,82,78,3,1,0,0,8376,142,8234,8376,4151,4225,8146,42,12101
42,71,12102,22184784,7099,2689,2689,0,2689,2626,63,7099,7099,0,0,7099,7049,6903,24,6,82,1,33,50,49,1,0,0,0,7099,99,7000,7099,3495,3604,6903,42,12102
42,71,12200,3608453,6905,2923,2923,0,2923,2820,103,6905,6905,0,0,6905,6842,6630,34,16,87,7,68,63,56,7,0,0,0,6905,230,6675,6905,3423,3482,6630,42,12200
42,71,12301,2496697,3238,1426,1426,0,1426,1376,50,3238,3238,0,0,3238,3207,3129,16,8,26,11,17,31,30,1,0,0,0,3238,55,3183,3238,1553,1685,3129,42,12301
42,71,12302,3110636,2986,1280,1280,0,1280,1242,38,2986,2986,0,0,2986,2951,2856,34,10,27,0,24,35,32,3,0,0,0,2986,79,2907,2986,1444,1542,2856,42,12302
42,71,12401,42142075,8110,2790,2790,0,2790,2730,60,8110,8110,0,0,8110,8052,7803,35,7,146,0,61,58,58,0,0,0,0,8110,142,7968,8110,3981,4129,7803,42,12401
42,71,12402,3274935,4046,1687,1687,0,1687,1622,65,4046,4046,0,0,4046,4020,3901,22,9,56,0,32,26,25,1,0,0,0,4046,90,3956,4046,1915,2131,3901,42,12402
42,71,12501,35577464,6441,2415,2415,0,2415,2340,75,6441,6441,0,0,6441,6397,6202,38,0,133,1,23,44,36,8,0,0,0,6441,60,6381,6441,3238,3203,6202,42,12501
42,71,12502,21334389,4714,1674,1674,0,1674,1621,53,4714,4714,0,0,4714,4669,4521,10,11,91,2,34,45,42,3,0,0,0,4714,88,4626,4714,2330,2384,4521,42,12502
42,71,12601,64537622,6699,2161,2161,0,2161,2115,46,6699,6699,0,0,6699,6649,6545,22,10,50,2,20,50,50,0,0,0,0,6699,64,6635,6699,3379,3320,6545,42,12601
42,71,12602,59517523,4278,1303,1303,0,1303,1269,34,4278,4278,0,0,4278,4269,4231,21,4,11,0,2,9,8,1,0,0,0,4278,28,4250,4278,2118,2160,4231,42,12602
42,71,12700,64910478,6960,2249,2249,0,2249,2178,71,6960,6960,0,0,6960,6916,6838,35,4,21,2,16,44,44,0,0,0,0,6960,61,6899,6960,3482,3478,6838,42,12700
42,71,12800,5395782,5092,2159,2159,0,2159,2084,75,5092,5092,0,0,5092,5007,4600,52,4,219,1,131,85,81,3,1,0,0,5092,327,4765,5092,2485,2607,4600,42,12800
42,71,12900,56853333,6183,2126,2126,0,2126,2019,107,6183,6183,0,0,6183,6134,6014,37,0,71,0,12,49,46,3,0,0,0,6183,66,6117,6183,2968,3215,6014,42,12900
42,71,13000,45699458,6766,2283,2283,0,2283,2201,82,6766,6766,0,0,6766,6742,6538,24,4,144,0,32,24,24,0,0,0,0,6766,102,6664,6766,3306,3460,6538,42,13000
42,71,13101,27830201,4692,1675,1675,0,1675,1635,40,4692,4692,0,0,4692,4639,4362,75,5,135,0,62,53,53,0,0,0,0,4692,179,4513,4692,2319,2373,4362,42,13101
42,71,13102,18800509,3537,1179,1179,0,1179,1142,37,3537,3537,0,0,3537,3485,3237,27,7,170,0,44,52,50,2,0,0,0,3537,88,3449,3537,1757,1780,3237,42,13102
42,71,13202,6976242,4404,1921,1921,0,1921,1846,75,4404,4404,0,0,4404,4333,3931,141,3,117,4,137,71,66,5,0,0,0,4404,264,4140,4404,2117,2287,3931,42,13202
42,71,13203,18377831,4192,1729,1729,0,1729,1662,67,4192,4192,0,0,4192,4155,3994,39,3,89,1,29,37,33,2,0,2,0,4192,87,4105,4192,2074,2118,3994,42,13203
42,71,13204,27983122,5861,2370,2370,0,2370,2235,135,5861,5861,0,0,5861,5804,5383,133,3,167,0,118,57,47,8,2,0,0,5861,244,5617,5861,2902,2959,5383,42,13204
42,71,13301,8910428,3661,1437,1437,0,1437,1393,44,3661,3661,0,0,3661,3627,3437,78,3,46,0,63,34,28,6,0,0,0,3661,120,3541,3661,1808,1853,3437,42,13301
42,71,13302,35697410,10536,4400,4400,0,4400,4254,146,10536,10536,0,0,10536,10487,10318,63,3,54,1,48,49,49,0,0,0,0,10536,163,10373,10536,4857,5679,10318,42,13302
42,71,13400,2094828,2106,928,928,0,928,877,51,2106,2106,0,0,2106,2032,1652,195,8,48,0,129,74,65,9,0,0,0,2106,241,1865,2106,1032,1074,1652,42,13400
42,71,13501,8941709,7195,3146,3146,0,3146,3043,103,7195,7195,0,0,7195,7025,5668,640,7,157,0,553,170,160,9,1,0,0,7195,955,6240,7195,3307,3888,5668,42,13501
42,71,13502,3571960,4495,1999,1999,0,1999,1938,61,4495,4495,0,0,4495,4434,4148,137,3,90,1,55,61,58,3,0,0,0,4495,198,4297,4495,2032,2463,4148,42,13502
42,71,13503,2386335,2497,1094,1094,0,1094,1066,28,2497,2497,0,0,2497,2488,2399,15,1,48,0,25,9,8,1,0,0,0,2497,50,2447,2497,1192,1305,2399,42,13503
42,71,13601,2346336,1458,625,625,0,625,609,16,1458,1458,0,0,1458,1449,1407,8,2,14,0,18,9,9,0,0,0,0,1458,36,1422,1458,678,780,1407,42,13601
42,71,13602,4272318,5921,1625,1625,0,1625,1511,114,5921,5921,0,0,5921,5869,5430,314,2,65,6,52,52,49,3,0,0,0,5921,124,5797,5921,2706,3215,5430,42,13602
42,71,13701,4803138,4228,1919,1919,0,1919,1835,84,4228,4228,0,0,4228,4166,3953,89,4,59,1,60,62,61,1,0,0,0,4228,148,4080,4228,1994,2234,3953,42,13701
42,71,13702,27426030,7316,2930,2930,0,2930,2827,103,7316,7316,0,0,7316,7248,6969,110,8,111,1,49,68,63,5,0,0,0,7316,178,7138,7316,3558,3758,6969,42,13702
42,71,13800,65683853,3924,1415,1415,0,1415,1383,32,3924,3924,0,0,3924,3915,3872,10,4,15,0,14,9,9,0,0,0,0,3924,41,3883,3924,2015,1909,3872,42,13800
42,71,13901,35239533,4358,1626,1626,0,1626,1581,45,4358,4358,0,0,4358,4323,4258,21,2,27,2,13,35,35,0,0,0,0,4358,45,4313,4358,2181,2177,4258,42,13901
42,71,13902,37878274,3749,1409,1409,0,1409,1374,35,3749,3749,0,0,3749,3722,3686,12,5,6,8,5,27,26,0,1,0,0,3749,37,3712,3749,1892,1857,3686,42,13902
42,71,14000,54462610,6821,2430,2430,0,2430,2385,45,6821,6821,0,0,6821,6776,6713,24,3,28,2,6,45,37,2,1,5,0,6821,22,6799,6821,3382,3439,6713,42,14000
42,71,14101,53522610,4878,1476,1476,0,1476,1426,50,4878,4878,0,0,4878,4855,4786,20,6,35,1,7,23,23,0,0,0,0,4878,29,4849,4878,2454,2424,4786,42,14101
42,71,14102,48216563,4698,1600,1600,0,1600,1554,46,4698,4698,0,0,4698,4671,4621,29,5,5,3,8,27,26,1,0,0,0,4698,34,4664,4698,2384,2314,4621,42,14102
42,71,14201,59119335,5082,1484,1484,0,1484,1449,35,5082,5082,0,0,5082,5037,4943,56,7,14,0,17,45,41,4,0,0,0,5082,51,5031,5082,2608,2474,4943,42,14201
42,71,14202,49285811,4930,1628,1628,0,1628,1578,50,4930,4930,0,0,4930,4897,4816,20,5,35,4,17,33,32,1,0,0,0,4930,57,4873,4930,2461,2469,4816,42,14202
42,71,14300,94431517,7152,2126,2126,0,2126,2083,43,7152,7152,0,0,7152,7119,7036,53,12,10,0,8,33,33,0,0,0,0,7152,61,7091,7152,3548,3604,7036,42,14300
42,71,14401,52156533,6651,2486,2486,0,2486,2387,99,6651,6651,0,0,6651,6591,6501,41,11,14,1,23,60,57,3,0,0,0,6651,61,6590,6651,3306,3345,6501,42,14401
42,71,14402,35575831,3850,1470,1470,0,1470,1416,54,3850,3850,0,0,3850,3822,3762,18,2,7,1,32,28,28,0,0,0,0,3850,63,3787,3850,1874,1976,3762,42,14402
42,71,14501,75157842,4990,1789,1789,0,1789,1713,76,4990,4990,0,0,4990,4961,4906,24,12,8,1,10,29,29,0,0,0,0,4990,68,4922,4990,2588,2402,4906,42,14501
42,71,14502,129019940,5069,1862,1862,0,1862,1671,191,5069,5069,0,0,5069,5037,4969,42,3,8,0,15,32,31,1,0,0,0,5069,50,5019,5069,2557,2512,4969,42,14502
42,71,14601,60139163,3535,1079,1079,0,1079,1055,24,3535,3535,0,0,3535,3523,3477,16,1,5,2,22,12,11,1,0,0,0,3535,29,3506,3535,1674,1861,3477,42,14601
42,71,14602,145510785,6775,2145,2145,0,2145,2079,66,6775,6775,0,0,6775,6720,6638,45,2,12,0,23,55,53,2,0,0,0,6775,72,6703,6775,3410,3365,6638,42,14602
42,73,100,2831192,4585,2080,2080,0,2080,1950,130,4585,4585,0,0,4585,4552,4469,66,0,13,0,4,33,33,0,0,0,0,4585,17,4568,4585,2134,2451,4469,42,100
42,73,200,3268198,2317,1020,1020,0,1020,959,61,2317,2317,0,0,2317,2289,2133,149,3,0,0,4,28,26,2,0,0,0,2317,28,2289,2317,1049,1268,2133,42,200
42,73,300,2208358,4291,1965,1965,0,1965,1756,209,4291,4291,0,0,4291,4189,3530,629,2,8,1,19,102,94,7,1,0,0,4291,49,4242,4291,1933,2358,3530,42,300
42,73,400,2686057,2420,1200,1200,0,1200,1052,148,2420,2420,0,0,2420,2320,1100,1194,5,8,0,13,100,89,10,1,0,0,2420,23,2397,2420,1018,1402,1100,42,400
42,73,600,530946,1608,550,550,0,550,476,74,1608,1608,0,0,1608,1553,1388,152,3,5,1,4,55,55,0,0,0,0,1608,18,1590,1608,857,751,1388,42,600
42,73,700,1053228,2312,963,963,0,963,867,96,2312,2312,0,0,2312,2285,2121,145,4,3,0,12,27,27,0,0,0,0,2312,23,2289,2312,1047,1265,2121,42,700
42,73,800,2158096,4641,2043,2043,0,2043,1941,102,4641,4641,0,0,4641,4592,4408,163,4,6,0,11,49,49,0,0,0,0,4641,20,4621,4641,2191,2450,4408,42,800
42,73,900,1853169,2184,1010,1010,0,1010,913,97,2184,2184,0,0,2184,2112,1772,328,3,1,0,8,72,70,2,0,0,0,2184,9,2175,2184,973,1211,1772,42,900
42,73,1000,4779770,1951,878,878,0,878,813,65,1951,1951,0,0,1951,1930,1908,13,4,2,0,3,21,21,0,0,0,0,1951,12,1939,1951,912,1039,1908,42,1000
42,73,10100,140048079,3916,1599,1599,0,1599,1444,155,3916,3916,0,0,3916,3895,3876,2,9,8,0,0,21,20,1,0,0,0,3916,11,3905,3916,1962,1954,3876,42,10100
42,73,10200,116095463,8171,3358,3358,0,3358,3203,155,8171,8171,0,0,8171,8131,8027,31,7,55,5,6,40,40,0,0,0,0,8171,44,8127,8171,3931,4240,8027,42,10200
42,73,10300,2745370,2452,611,611,0,611,577,34,2452,2452,0,0,2452,2444,2408,14,5,11,0,6,8,5,1,2,0,0,2452,11,2441,2452,937,1515,2408,42,10300
42,73,10400,78925505,3658,1358,1358,0,1358,1292,66,3658,3658,0,0,3658,3646,3620,10,3,5,0,8,12,12,0,0,0,0,3658,11,3647,3658,1758,1900,3620,42,10400
42,73,10500,63585607,3447,1436,1436,0,1436,1373,63,3447,3447,0,0,3447,3431,3407,10,4,6,0,4,16,16,0,0,0,0,3447,12,3435,3447,1688,1759,3407,42,10500
42,73,10600,20428945,2289,1010,1010,0,1010,959,51,2289,2289,0,0,2289,2288,2247,30,1,4,0,6,1,1,0,0,0,0,2289,10,2279,2289,1082,1207,2247,42,10600
42,73,10700,4859251,2866,1241,1241,0,1241,1184,57,2866,2866,0,0,2866,2839,2648,178,0,4,0,9,27,27,0,0,0,0,2866,17,2849,2866,1378,1488,2648,42,10700
42,73,10800,22305638,6161,2593,2593,0,2593,2481,112,6161,6161,0,0,6161,6140,6075,10,5,48,1,1,21,21,0,0,0,0,6161,20,6141,6161,2833,3328,6075,42,10800
42,73,10900,78024162,3179,1285,1285,0,1285,1203,82,3179,3179,0,0,3179,3169,3153,2,6,4,0,4,10,10,0,0,0,0,3179,12,3167,3179,1579,1600,3153,42,10900
42,73,11000,32977810,5109,1979,1979,0,1979,1895,84,5109,5109,0,0,5109,5089,4944,113,1,5,1,25,20,20,0,0,0,0,5109,47,5062,5109,2613,2496,4944,42,11000
42,73,11100,44724120,4478,1825,1825,0,1825,1720,105,4478,4478,0,0,4478,4462,4403,36,9,4,0,10,16,15,1,0,0,0,4478,15,4463,4478,2196,2282,4403,42,11100
42,73,11200,36669764,2584,1073,1073,0,1073,1019,54,2584,2584,0,0,2584,2569,2547,8,0,12,0,2,15,15,0,0,0,0,2584,17,2567,2584,1263,1321,2547,42,11200
42,73,11300,135228132,4307,1654,1654,0,1654,1552,102,4307,4307,0,0,4307,4279,4260,5,1,10,0,3,28,27,1,0,0,0,4307,23,4284,4307,2131,2176,4260,42,11300
42,73,11400,39862187,2355,1006,1006,0,1006,942,64,2355,2355,0,0,2355,2348,2305,36,3,3,0,1,7,7,0,0,0,0,2355,15,2340,2355,1161,1194,2305,42,11400
42,73,11500,88773590,3822,1532,1532,0,1532,1454,78,3822,3822,0,0,3822,3801,3772,15,4,10,0,0,21,20,1,0,0,0,3822,15,3807,3822,1928,1894,3772,42,11500
42,73,11600,2984601,4462,1913,1913,0,1913,1833,80,4462,4462,0,0,4462,4442,4402,24,4,8,0,4,20,14,6,0,0,0,4462,23,4439,4462,2086,2376,4402,42,11600
42,73,11700,2517655,2179,969,969,0,969,915,54,2179,2179,0,0,2179,2168,2140,13,2,12,0,1,11,11,0,0,0,0,2179,7,2172,2179,1032,1147,2140,42,11700
42,73,11800,1464017,2899,1484,1484,0,1484,1318,166,2899,2899,0,0,2899,2885,2831,40,3,3,0,8,14,14,0,0,0,0,2899,20,2879,2899,1322,1577,2831,42,11800
42,75,100,1600239,4693,2356,2356,0,2356,2104,252,4693,4693,0,0,4693,4633,4181,165,5,50,6,226,60,56,3,1,0,0,4693,454,4239,4693,2383,2310,4181,42,100
42,75,200,2554867,4690,2306,2306,0,2306,2127,179,4690,4690,0,0,4690,4642,4255,123,12,51,12,189,48,46,2,0,0,0,4690,379,4311,4690,2219,2471,4255,42,200
42,75,300,2033589,4166,1742,1742,0,1742,1557,185,4166,4166,0,0,4166,4024,2964,211,23,57,0,769,142,139,2,1,0,0,4166,1398,2768,4166,2066,2100,2964,42,300
42,75,400,2679813,7383,3234,3234,0,3234,2986,248,7383,7383,0,0,7383,7256,6400,191,23,61,5,576,127,123,4,0,0,0,7383,1275,6108,7383,3523,3860,6400,42,400
42,75,500,1970782,3529,1582,1582,0,1582,1492,90,3529,3529,0,0,3529,3476,3115,100,6,30,2,223,53,50,3,0,0,0,3529,513,3016,3529,1666,1863,3115,42,500
42,75,2000,140500144,2639,1130,1130,0,1130,1036,94,2639,2639,0,0,2639,2619,2591,5,6,8,0,9,20,20,0,0,0,0,2639,24,2615,2639,1351,1288,2591,42,2000
42,75,2100,89931656,4526,1710,1710,0,1710,1608,102,4526,4526,0,0,4526,4505,4442,12,5,11,0,35,21,21,0,0,0,0,4526,70,4456,4526,2302,2224,4442,42,2100
42,75,2200,56503807,4969,1905,1905,0,1905,1834,71,4969,4969,0,0,4969,4943,4839,57,9,25,0,13,26,26,0,0,0,0,4969,58,4911,4969,2533,2436,4839,42,2200
42,75,2300,84524330,2858,1091,1091,0,1091,1034,57,2858,2858,0,0,2858,2832,2767,18,7,15,1,24,26,26,0,0,0,0,2858,64,2794,2858,1451,1407,2767,42,2300
42,75,2400,45108553,2279,861,861,0,861,828,33,2279,2279,0,0,2279,2264,2256,0,4,2,1,1,15,15,0,0,0,0,2279,17,2262,2279,1124,1155,2256,42,2400
42,75,2500,4084875,4518,1556,1556,0,1556,1452,104,4518,4518,0,0,4518,4465,4310,49,1,56,5,44,53,53,0,0,0,0,4518,81,4437,4518,2116,2402,4310,42,2500
42,75,2600,2256994,2148,913,913,0,913,879,34,2148,2148,0,0,2148,2130,2074,22,1,26,1,6,18,17,1,0,0,0,2148,29,2119,2148,1057,1091,2074,42,2600
42,75,2701,23194698,5372,2069,2069,0,2069,1991,78,5372,5372,0,0,5372,5333,5175,30,8,85,0,35,39,34,4,1,0,0,5372,133,5239,5372,2624,2748,5175,42,2701
42,75,2702,20568108,5257,2165,2165,0,2165,2081,84,5257,5257,0,0,5257,5199,4871,88,5,39,0,196,58,55,3,0,0,0,5257,437,4820,5257,2569,2688,4871,42,2702
42,75,2800,61625206,6338,2478,2478,0,2478,2397,81,6338,6338,0,0,6338,6316,6249,18,6,23,1,19,22,20,2,0,0,0,6338,48,6290,6338,3059,3279,6249,42,2800
42,75,2900,2307586,3171,1339,1339,0,1339,1265,74,3171,3171,0,0,3171,3158,3091,46,0,14,0,7,13,11,2,0,0,0,3171,30,3141,3171,1464,1707,3091,42,2900
42,75,3000,56772276,4429,1692,1692,0,1692,1625,67,4429,4429,0,0,4429,4397,4338,27,0,10,0,22,32,32,0,0,0,0,4429,46,4383,4429,2203,2226,4338,42,3000
42,75,3100,62634106,3832,1389,1389,0,1389,1346,43,3832,3832,0,0,3832,3825,3805,8,0,7,0,5,7,6,1,0,0,0,3832,14,3818,3832,1918,1914,3805,42,3100
42,75,3200,47529109,3335,1222,1222,0,1222,1195,27,3335,3335,0,0,3335,3312,3201,37,1,47,0,26,23,22,1,0,0,0,3335,64,3271,3335,1626,1709,3201,42,3200
42,75,3300,3806488,2619,798,798,0,798,749,49,2619,2619,0,0,2619,2602,2484,52,5,14,1,46,17,17,0,0,0,0,2619,148,2471,2619,1312,1307,2484,42,3300
42,75,3400,5043774,2429,1010,1010,0,1010,976,34,2429,2429,0,0,2429,2415,2340,43,2,19,0,11,14,14,0,0,0,0,2429,43,2386,2429,1242,1187,2340,42,3400
42,75,3500,23643595,4205,1670,1670,0,1670,1572,98,4205,4205,0,0,4205,4163,3957,47,3,111,4,41,42,42,0,0,0,0,4205,109,4096,4205,2012,2193,3957,42,3500
42,75,3600,2045784,3034,1280,1280,0,1280,1228,52,3034,3034,0,0,3034,2969,2748,61,7,39,0,114,65,60,5,0,0,0,3034,251,2783,3034,1443,1591,2748,42,3600
42,75,3700,50892905,2946,1129,1129,0,1129,1095,34,2946,2946,0,0,2946,2933,2884,11,1,22,0,15,13,13,0,0,0,0,2946,37,2909,2946,1443,1503,2884,42,3700
42,75,3800,27991824,6771,2782,2782,0,2782,2716,66,6771,6771,0,0,6771,6729,6621,9,0,85,0,14,42,33,4,5,0,0,6771,86,6685,6771,3199,3572,6621,42,3800
42,75,3900,4818316,7096,3363,3363,0,3363,3200,163,7096,7096,0,0,7096,7025,6863,64,8,65,1,24,71,71,0,0,0,0,7096,85,7011,7096,3327,3769,6863,42,3900
42,75,4000,62322350,5458,2138,2138,0,2138,2062,76,5458,5458,0,0,5458,5422,5341,29,2,39,0,11,36,33,3,0,0,0,5458,32,5426,5458,2663,2795,5341,42,4000
42,75,4100,22986134,2151,1149,1149,0,1149,906,243,2151,2151,0,0,2151,2130,2091,13,0,19,3,4,21,21,0,0,0,0,2151,18,2133,2151,1067,1084,2091,42,4100
42,75,4200,25272858,3486,1261,1261,0,1261,1210,51,3486,3486,0,0,3486,3476,3409,12,7,37,0,11,10,9,1,0,0,0,3486,26,3460,3486,1648,1838,3409,42,4200
42,77,100,5300660,7412,3407,3407,0,3407,3086,321,7412,7412,0,0,7412,7109,5968,409,11,223,10,488,303,285,17,1,0,0,7412,966,6446,7412,3568,3844,5968,42,100
42,77,200,1713139,589,230,230,0,230,217,13,589,589,0,0,589,582,518,40,3,0,0,21,7,7,0,0,0,0,589,64,525,589,296,293,518,42,200
42,77,300,2557291,6867,2804,2804,0,2804,2641,163,6867,6867,0,0,6867,6523,4627,632,20,80,8,1156,344,339,5,0,0,0,6867,2344,4523,6867,3278,3589,4627,42,300
42,77,400,956995,3431,1278,1278,0,1278,1180,98,3431,3431,0,0,3431,3140,2188,184,22,108,3,635,291,282,9,0,0,0,3431,1181,2250,3431,1649,1782,2188,42,400
42,77,500,1060348,2252,795,795,0,795,684,111,2252,2252,0,0,2252,2113,963,338,19,27,0,766,139,125,12,2,0,0,2252,1336,916,2252,1147,1105,963,42,500
42,77,600,2559017,5766,2227,2227,0,2227,2131,96,5766,5766,0,0,5766,5622,4039,358,20,171,5,1029,144,142,2,0,0,0,5766,1609,4157,5766,2756,3010,4039,42,600
42,77,700,832418,3449,1302,1302,0,1302,1167,135,3449,3449,0,0,3449,3265,1979,415,22,74,10,765,184,180,4,0,0,0,3449,1391,2058,3449,1666,1783,1979,42,700
42,77,800,311529,3615,1388,1388,0,1388,1144,244,3615,3615,0,0,3615,3424,1742,400,22,82,0,1178,191,188,3,0,0,0,3615,1873,1742,3615,1856,1759,1742,42,800
42,77,900,227858,1655,669,669,0,669,544,125,1655,1655,0,0,1655,1584,803,186,11,28,4,552,71,67,4,0,0,0,1655,939,716,1655,789,866,803,42,900
42,77,1000,314051,2819,1251,1251,0,1251,964,287,2819,2819,0,0,2819,2675,1283,425,35,33,0,899,144,143,1,0,0,0,2819,1639,1180,2819,1344,1475,1283,42,1000
42,77,1100,363330,882,564,564,0,564,398,166,882,882,0,0,882,849,494,129,6,1,0,219,33,33,0,0,0,0,882,403,479,882,479,403,494,42,1100
42,77,1200,377801,2213,641,641,0,641,575,66,2213,2213,0,0,2213,2125,1188,530,11,60,0,336,88,86,2,0,0,0,2213,819,1394,2213,1484,729,1188,42,1200
42,77,1300,565987,2047,1104,1104,0,1104,937,167,2047,2047,0,0,2047,1965,1228,272,8,18,0,439,82,80,2,0,0,0,2047,858,1189,2047,950,1097,1228,42,1300
42,77,1401,3166901,6398,3004,3004,0,3004,2775,229,6398,6398,0,0,6398,6191,5095,417,23,201,5,450,207,194,10,3,0,0,6398,928,5470,6398,3126,3272,5095,42,1401
42,77,1402,4731312,2146,1006,1006,0,1006,968,38,2146,2146,0,0,2146,2118,1999,43,6,39,0,31,28,23,5,0,0,0,2146,93,2053,2146,1011,1135,1999,42,1402
42,77,1501,3547508,6033,2598,2598,0,2598,2472,126,6033,6033,0,0,6033,5843,4206,469,20,225,6,917,190,181,8,1,0,0,6033,1678,4355,6033,2957,3076,4206,42,1501
42,77,1502,3080871,6042,2865,2865,0,2865,2689,176,6042,6042,0,0,6042,5919,4949,402,9,265,2,292,123,120,3,0,0,0,6042,527,5515,6042,2985,3057,4949,42,1502
42,77,1600,331109,3259,1282,1282,0,1282,1128,154,3259,3259,0,0,3259,3058,1876,414,2,50,9,707,201,183,17,1,0,0,3259,1301,1958,3259,1563,1696,1876,42,1600
42,77,1700,468090,4006,1591,1591,0,1591,1446,145,4006,4006,0,0,4006,3822,2647,348,16,110,6,695,184,180,4,0,0,0,4006,1296,2710,4006,1928,2078,2647,42,1700
42,77,1800,538669,4043,1944,1944,0,1944,1629,315,4043,4043,0,0,4043,3863,2453,517,15,15,0,863,180,170,9,1,0,0,4043,1559,2484,4043,1982,2061,2453,42,1800
42,77,1900,1364329,4001,1926,1926,0,1926,1842,84,4001,4001,0,0,4001,3928,3400,178,5,40,4,301,73,70,3,0,0,0,4001,537,3464,4001,1721,2280,3400,42,1900
42,77,2000,554986,4479,2104,2104,0,2104,1881,223,4479,4479,0,0,4479,4320,3120,449,12,47,2,690,159,142,17,0,0,0,4479,1119,3360,4479,2171,2308,3120,42,2000
42,77,2100,1224752,6075,3013,3013,0,3013,2842,171,6075,6075,0,0,6075,5875,4643,473,27,191,1,540,200,183,17,0,0,0,6075,1003,5072,6075,2803,3272,4643,42,2100
42,77,2201,1271689,4410,2090,2090,0,2090,2008,82,4410,4410,0,0,4410,4351,4143,94,2,57,1,54,59,59,0,0,0,0,4410,170,4240,4410,2052,2358,4143,42,2201
42,77,2202,1283763,4017,1004,1004,0,1004,971,33,4017,4017,0,0,4017,3952,3675,102,6,43,0,126,65,62,3,0,0,0,4017,193,3824,4017,1584,2433,3675,42,2202
42,77,2301,4970516,5686,2661,2661,0,2661,2530,131,5686,5686,0,0,5686,5644,5316,73,0,190,0,65,42,41,1,0,0,0,5686,139,5547,5686,2673,3013,5316,42,2301
42,77,2302,2267067,3040,1212,1212,0,1212,1183,29,3040,3040,0,0,3040,2986,2819,73,3,43,2,46,54,52,2,0,0,0,3040,93,2947,3040,1219,1821,2819,42,2302
42,77,5100,3423394,4434,1867,1867,0,1867,1743,124,4434,4434,0,0,4434,4391,4267,63,9,17,1,34,43,42,1,0,0,0,4434,90,4344,4434,2157,2277,4267,42,5100
42,77,5200,61282984,6588,2594,2594,0,2594,2512,82,6588,6588,0,0,6588,6565,6503,14,5,27,0,16,23,18,5,0,0,0,6588,64,6524,6588,3342,3246,6503,42,5200
42,77,5300,171314961,7128,2687,2687,0,2687,2584,103,7128,7128,0,0,7128,7077,7011,18,6,19,0,23,51,46,5,0,0,0,7128,72,7056,7128,3618,3510,7011,42,5300
42,77,5400,105704422,6013,2217,2217,0,2217,2135,82,6013,6013,0,0,6013,5963,5890,28,3,24,0,18,50,49,1,0,0,0,6013,71,5942,6013,3030,2983,5890,42,5400
42,77,5501,50569190,7839,2888,2888,0,2888,2751,137,7839,7839,0,0,7839,7771,7652,42,5,43,1,28,68,67,1,0,0,0,7839,105,7734,7839,3979,3860,7652,42,5501
42,77,5502,23297628,6892,2585,2585,0,2585,2499,86,6892,6892,0,0,6892,6823,6613,81,8,63,1,57,69,64,5,0,0,0,6892,139,6753,6892,3346,3546,6613,42,5502
42,77,5601,14771526,4522,1776,1776,0,1776,1744,32,4522,4522,0,0,4522,4501,4389,51,3,37,2,19,21,21,0,0,0,0,4522,75,4447,4522,2165,2357,4389,42,5601
42,77,5602,5347700,5199,2180,2180,0,2180,2117,63,5199,5199,0,0,5199,5171,5006,70,6,48,4,37,28,28,0,0,0,0,5199,130,5069,5199,2514,2685,5006,42,5602
42,77,5701,7271512,7537,3283,3283,0,3283,3156,127,7537,7537,0,0,7537,7428,6419,233,6,613,7,150,109,105,4,0,0,0,7537,366,7171,7537,3666,3871,6419,42,5701
42,77,5702,3362572,4119,1962,1962,0,1962,1874,88,4119,4119,0,0,4119,4082,3961,55,0,40,0,26,37,37,0,0,0,0,4119,105,4014,4119,1896,2223,3961,42,5702
42,77,5703,1793820,3519,1543,1543,0,1543,1485,58,3519,3519,0,0,3519,3421,2770,273,17,164,3,194,98,89,9,0,0,0,3519,413,3106,3519,1690,1829,2770,42,5703
42,77,5800,1632632,3387,1484,1484,0,1484,1431,53,3387,3387,0,0,3387,3365,3280,53,3,11,0,18,22,20,2,0,0,0,3387,77,3310,3387,1568,1819,3280,42,5800
42,77,5901,3277738,6588,2747,2747,0,2747,2616,131,6588,6588,0,0,6588,6509,6298,78,22,39,1,71,79,75,4,0,0,0,6588,233,6355,6588,3193,3395,6298,42,5901
42,77,5902,10898640,1913,937,937,0,937,892,45,1913,1913,0,0,1913,1883,1648,106,1,90,0,38,30,28,2,0,0,0,1913,117,1796,1913,939,974,1648,42,5902
42,77,6001,11383882,4613,1872,1872,0,1872,1831,41,4613,4613,0,0,4613,4579,4449,58,2,52,0,18,34,33,1,0,0,0,4613,65,4548,4613,2212,2401,4449,42,6001
42,77,6002,22688842,5107,1884,1884,0,1884,1825,59,5107,5107,0,0,5107,5068,4833,47,0,169,0,19,39,37,1,1,0,0,5107,74,5033,5107,2521,2586,4833,42,6002
42,77,6101,6384209,4016,1501,1501,0,1501,1431,70,4016,4016,0,0,4016,3988,3824,43,3,90,0,28,28,28,0,0,0,0,4016,93,3923,4016,1561,2455,3824,42,6101
42,77,6102,3892456,4292,1897,1897,0,1897,1856,41,4292,4292,0,0,4292,4255,4141,36,1,62,0,15,37,34,3,0,0,0,4292,40,4252,4292,2018,2274,4141,42,6102
42,77,6201,29846851,9203,3318,3318,0,3318,3208,110,9203,9203,0,0,9203,9104,8421,118,4,503,0,58,99,92,2,0,5,0,9203,175,9028,9203,4433,4770,8421,42,6201
42,77,6202,38114762,4692,2017,2017,0,2017,1920,97,4692,4692,0,0,4692,4652,4496,46,1,85,0,24,40,36,4,0,0,0,4692,60,4632,4692,2260,2432,4496,42,6202
42,77,6302,25657692,3641,1468,1468,0,1468,1409,59,3641,3641,0,0,3641,3614,3532,12,3,42,5,20,27,27,0,0,0,0,3641,33,3608,3641,1798,1843,3532,42,6302
42,77,6303,2574759,3039,1418,1418,0,1418,1366,52,3039,3039,0,0,3039,3016,2883,41,2,64,1,25,23,18,1,2,2,0,3039,41,2998,3039,1446,1593,2883,42,6303
42,77,6304,8554715,3663,1420,1420,0,1420,1379,41,3663,3663,0,0,3663,3640,3341,11,8,275,0,5,23,23,0,0,0,0,3663,29,3634,3663,1786,1877,3341,42,6304
42,77,6305,7754676,5540,2075,2075,0,2075,2023,52,5540,5540,0,0,5540,5491,5204,25,8,217,0,37,49,39,10,0,0,0,5540,87,5453,5540,2674,2866,5204,42,6305
42,77,6306,18324593,8493,3241,3241,0,3241,3121,120,8493,8493,0,0,8493,8439,8004,71,4,324,0,36,54,54,0,0,0,0,8493,161,8332,8493,4183,4310,8004,42,6306
42,77,6400,46619438,7234,2805,2805,0,2805,2728,77,7234,7234,0,0,7234,7195,7074,17,6,80,0,18,39,38,1,0,0,0,7234,76,7158,7234,3660,3574,7074,42,6400
42,77,6500,3781161,5608,2635,2635,0,2635,2529,106,5608,5608,0,0,5608,5562,5383,44,6,49,2,78,46,45,1,0,0,0,5608,113,5495,5608,2665,2943,5383,42,6500
42,77,6600,3455321,5360,2322,2322,0,2322,2242,80,5360,5360,0,0,5360,5335,5163,29,1,123,1,18,25,24,1,0,0,0,5360,52,5308,5360,2574,2786,5163,42,6600
42,77,6701,7839932,4671,1904,1904,0,1904,1861,43,4671,4671,0,0,4671,4649,4453,98,1,41,4,52,22,21,1,0,0,0,4671,132,4539,4671,2289,2382,4453,42,6701
42,77,6702,13046726,2908,1133,1133,0,1133,1075,58,2908,2908,0,0,2908,2865,2735,68,4,23,0,35,43,42,1,0,0,0,2908,89,2819,2908,1520,1388,2735,42,6702
42,77,6703,7653542,5919,2244,2244,0,2244,2202,42,5919,5919,0,0,5919,5894,5691,38,0,136,1,28,25,25,0,0,0,0,5919,68,5851,5919,2799,3120,5691,42,6703
42,77,6800,1826474,4614,2029,2029,0,2029,1911,118,4614,4614,0,0,4614,4511,4007,176,9,42,0,277,103,94,9,0,0,0,4614,495,4119,4614,2107,2507,4007,42,6800
42,77,6902,2472089,2582,1050,1050,0,1050,983,67,2582,2582,0,0,2582,2556,2479,18,2,44,1,12,26,22,4,0,0,0,2582,46,2536,2582,1254,1328,2479,42,6902
42,77,6903,32720394,4968,1601,1601,0,1601,1531,70,4968,4968,0,0,4968,4935,4821,41,3,50,1,19,33,32,1,0,0,0,4968,68,4900,4968,2463,2505,4821,42,6903
42,77,6904,31112768,6971,2516,2516,0,2516,2439,77,6971,6971,0,0,6971,6933,6773,42,4,85,0,29,38,35,3,0,0,0,6971,60,6911,6971,3499,3472,6773,42,6904
42,77,7000,50896095,3617,1308,1308,0,1308,1277,31,3617,3617,0,0,3617,3587,3548,6,9,20,0,4,30,25,5,0,0,0,3617,25,3592,3617,1828,1789,3548,42,7000
42,77,9100,4215475,3242,1474,1474,0,1474,1435,39,3242,3242,0,0,3242,3227,3100,26,2,72,0,27,15,15,0,0,0,0,3242,98,3144,3242,1357,1885,3100,42,9100
42,77,9200,1875358,3700,1855,1855,0,1855,1798,57,3700,3700,0,0,3700,3661,3428,81,2,116,1,33,39,33,5,0,0,1,3700,92,3608,3700,1767,1933,3428,42,9200
42,77,9300,1801517,3213,1385,1385,0,1385,1346,39,3213,3213,0,0,3213,3173,3029,56,4,36,0,48,40,39,1,0,0,0,3213,130,3083,3213,1487,1726,3029,42,9300
42,77,9400,2010982,3929,1630,1630,0,1630,1545,85,3929,3929,0,0,3929,3819,3323,146,5,43,0,302,110,101,8,0,1,0,3929,758,3171,3929,1727,2202,3323,42,9400
42,77,9500,1454635,4945,2198,2198,0,2198,2064,134,4945,4945,0,0,4945,4838,4387,168,9,53,1,220,107,102,3,2,0,0,4945,606,4339,4945,2526,2419,4387,42,9500
42,79,200100,1756213,3097,1300,1300,0,1300,1109,191,3097,3097,0,0,3097,3056,2862,138,3,33,1,19,41,40,1,0,0,0,3097,54,3043,3097,1414,1683,2862,42,200100
42,79,200200,1072229,3638,1708,1708,0,1708,1506,202,3638,3638,0,0,3638,3581,3390,136,1,41,0,13,57,46,6,0,5,0,3638,42,3596,3638,1752,1886,3390,42,200200
42,79,200300,1002586,1935,831,831,0,831,773,58,1935,1935,0,0,1935,1917,1827,68,1,15,3,3,18,18,0,0,0,0,1935,2,1933,1935,936,999,1827,42,200300
42,79,200400,824822,2725,1254,1254,0,1254,1131,123,2725,2725,0,0,2725,2697,2538,115,5,31,0,8,28,27,1,0,0,0,2725,24,2701,2725,1297,1428,2538,42,200400
42,79,200500,1015702,2882,1656,1656,0,1656,1292,364,2882,2882,0,0,2882,2849,2526,221,8,53,1,40,33,32,1,0,0,0,2882,86,2796,2882,1486,1396,2526,42,200500
42,79,200600,615427,2199,1023,1023,0,1023,899,124,2199,2199,0,0,2199,2174,2097,57,4,4,0,12,25,25,0,0,0,0,2199,24,2175,2199,1068,1131,2097,42,200600
42,79,200700,996351,3645,1760,1760,0,1760,1578,182,3645,3645,0,0,3645,3584,3426,128,2,14,1,13,61,52,9,0,0,0,3645,30,3615,3645,1700,1945,3426,42,200700
42,79,200800,936290,3618,1712,1712,0,1712,1531,181,3618,3618,0,0,3618,3545,3125,340,6,53,2,19,73,63,10,0,0,0,3618,80,3538,3618,1591,2027,3125,42,200800
42,79,200900,870359,3232,1728,1728,0,1728,1557,171,3232,3232,0,0,3232,3203,2900,236,4,45,2,16,29,25,4,0,0,0,3232,65,3167,3232,1502,1730,2900,42,200900
42,79,201000,894708,2415,1333,1333,0,1333,1172,161,2415,2415,0,0,2415,2366,2079,261,5,8,0,13,49,47,2,0,0,0,2415,44,2371,2415,1063,1352,2079,42,201000
42,79,201100,358888,1249,600,600,0,600,514,86,1249,1249,0,0,1249,1243,1166,47,3,5,0,22,6,6,0,0,0,0,1249,49,1200,1249,619,630,1166,42,201100
42,79,201200,840416,2749,784,784,0,784,675,109,2749,2749,0,0,2749,2730,2439,248,0,4,2,37,19,17,1,0,1,0,2749,66,2683,2749,1713,1036,2439,42,201200
42,79,201300,1251707,2032,997,997,0,997,893,104,2032,2032,0,0,2032,2024,1963,45,1,12,0,3,8,8,0,0,0,0,2032,30,2002,2032,965,1067,1963,42,201300
42,79,201400,877081,2299,1112,1112,0,1112,1006,106,2299,2299,0,0,2299,2271,2174,67,4,16,1,9,28,27,1,0,0,0,2299,64,2235,2299,1118,1181,2174,42,201400
42,79,201500,1846321,2399,1081,1081,0,1081,1007,74,2399,2399,0,0,2399,2384,2310,72,0,1,1,0,15,14,1,0,0,0,2399,10,2389,2399,1123,1276,2310,42,201500
42,79,201600,2579548,3009,1415,1415,0,1415,1318,97,3009,3009,0,0,3009,3002,2979,14,1,7,0,1,7,7,0,0,0,0,3009,13,2996,3009,1452,1557,2979,42,201600
42,79,210100,37198700,3450,1437,1437,0,1437,1340,97,3450,3450,0,0,3450,3436,3421,10,0,3,0,2,14,14,0,0,0,0,3450,12,3438,3450,1702,1748,3421,42,210100
42,79,210200,3932146,2719,1354,1354,0,1354,1228,126,2719,2719,0,0,2719,2712,2698,12,0,2,0,0,7,7,0,0,0,0,2719,3,2716,2719,1279,1440,2698,42,210200
42,79,210300,2317635,2851,1267,1267,0,1267,1177,90,2851,2851,0,0,2851,2847,2830,4,0,4,6,3,4,4,0,0,0,0,2851,3,2848,2851,1375,1476,2830,42,210300
42,79,210400,2300950,1541,659,659,0,659,615,44,1541,1541,0,0,1541,1536,1531,2,0,0,1,2,5,5,0,0,0,0,1541,2,1539,1541,760,781,1531,42,210400
42,79,210500,14271642,4634,2151,2151,0,2151,1984,167,4634,4634,0,0,4634,4618,4581,12,5,16,0,4,16,16,0,0,0,0,4634,14,4620,4634,2172,2462,4581,42,210500
42,79,210600,716168,1267,693,693,0,693,617,76,1267,1267,0,0,1267,1264,1256,2,0,4,0,2,3,3,0,0,0,0,1267,10,1257,1267,592,675,1256,42,210600
42,79,210700,1737489,1862,799,799,0,799,738,61,1862,1862,0,0,1862,1853,1826,9,0,9,1,8,9,9,0,0,0,0,1862,15,1847,1862,840,1022,1826,42,210700
42,79,210800,1109128,3327,1641,1641,0,1641,1476,165,3327,3327,0,0,3327,3321,3283,22,3,9,0,4,6,6,0,0,0,0,3327,11,3316,3327,1521,1806,3283,42,210800
42,79,210900,575023,1648,769,769,0,769,699,70,1648,1648,0,0,1648,1638,1608,22,4,3,1,0,10,4,3,3,0,0,1648,19,1629,1648,759,889,1608,42,210900
42,79,211000,2119074,5072,2381,2381,0,2381,2243,138,5072,5072,0,0,5072,5054,5040,5,2,2,0,5,18,16,2,0,0,0,5072,12,5060,5072,2292,2780,5040,42,211000
42,79,211101,12064310,5955,2641,2641,0,2641,2482,159,5955,5955,0,0,5955,5924,5877,29,8,8,0,2,31,29,2,0,0,0,5955,34,5921,5955,2718,3237,5877,42,211101
42,79,211102,33370148,2557,1038,1038,0,1038,943,95,2557,2557,0,0,2557,2556,2539,2,1,2,4,8,1,1,0,0,0,0,2557,9,2548,2557,1285,1272,2539,42,211102
42,79,211201,5929686,2557,1094,1094,0,1094,1031,63,2557,2557,0,0,2557,2542,2505,12,2,20,0,3,15,15,0,0,0,0,2557,17,2540,2557,1211,1346,2505,42,211201
42,79,211202,48508531,8179,3125,3125,0,3125,2917,208,8179,8179,0,0,8179,8145,8052,17,5,59,1,11,34,30,4,0,0,0,8179,46,8133,8179,3686,4493,8052,42,211202
42,79,211203,32934003,1601,679,679,0,679,629,50,1601,1601,0,0,1601,1596,1594,1,0,0,0,1,5,5,0,0,0,0,1601,14,1587,1601,810,791,1594,42,211203
42,79,211301,34386096,4453,1004,1004,0,1004,952,52,4453,4453,0,0,4453,4421,3251,1098,5,40,1,26,32,32,0,0,0,0,4453,185,4268,4453,3154,1299,3251,42,211301
42,79,211302,56112706,3206,1403,1403,0,1403,1226,177,3206,3206,0,0,3206,3194,3153,15,9,17,0,0,12,12,0,0,0,0,3206,5,3201,3206,1573,1633,3153,42,211302
42,79,211303,13848375,2888,1735,1735,0,1735,1185,550,2888,2888,0,0,2888,2867,2833,4,9,11,1,9,21,19,0,2,0,0,2888,22,2866,2888,1428,1460,2833,42,211303
42,79,211304,69887980,2110,865,865,0,865,800,65,2110,2110,0,0,2110,2106,2093,0,4,3,3,3,4,4,0,0,0,0,2110,4,2106,2110,1070,1040,2093,42,211304
42,79,211400,35169587,7145,2923,2923,0,2923,2745,178,7145,7145,0,0,7145,7117,7070,17,4,20,0,6,28,26,2,0,0,0,7145,27,7118,7145,3516,3629,7070,42,211400
42,79,211500,9405150,2833,1240,1240,0,1240,1183,57,2833,2833,0,0,2833,2823,2814,5,0,2,1,1,10,10,0,0,0,0,2833,7,2826,2833,1363,1470,2814,42,211500
42,79,211600,3672430,3221,1580,1580,0,1580,1487,93,3221,3221,0,0,3221,3215,3205,2,0,2,1,5,6,6,0,0,0,0,3221,9,3212,3221,1459,1762,3205,42,211600
42,79,211701,36622683,5233,2084,2084,0,2084,1948,136,5233,5233,0,0,5233,5211,5184,13,3,7,1,3,22,22,0,0,0,0,5233,23,5210,5233,2373,2860,5184,42,211701
42,79,211702,3501391,1502,632,632,0,632,612,20,1502,1502,0,0,1502,1495,1436,2,0,55,0,2,7,7,0,0,0,0,1502,9,1493,1502,707,795,1436,42,211702
42,79,211800,19974896,2447,1023,1023,0,1023,900,123,2447,2447,0,0,2447,2434,2344,25,1,58,0,6,13,12,1,0,0,0,2447,27,2420,2447,1267,1180,2344,42,211800
42,79,211900,12661532,6458,3036,3036,0,3036,2772,264,6458,6458,0,0,6458,6444,6419,12,1,9,0,3,14,13,1,0,0,0,6458,14,6444,6458,3091,3367,6419,42,211900
42,79,212000,1722950,2001,948,948,0,948,884,64,2001,2001,0,0,2001,1998,1961,15,1,20,0,1,3,3,0,0,0,0,2001,15,1986,2001,920,1081,1961,42,212000
42,79,212100,3469432,4579,2098,2098,0,2098,1989,109,4579,4579,0,0,4579,4560,4509,23,3,17,0,8,19,18,1,0,0,0,4579,24,4555,4579,2123,2456,4509,42,212100
42,79,212200,5596856,5157,2356,2356,0,2356,2243,113,5157,5157,0,0,5157,5137,5117,5,3,8,0,4,20,20,0,0,0,0,5157,8,5149,5157,2434,2723,5117,42,212200
42,79,212300,1778344,2952,1520,1520,0,1520,1410,110,2952,2952,0,0,2952,2938,2920,10,0,2,0,6,14,13,1,0,0,0,2952,13,2939,2952,1388,1564,2920,42,212300
42,79,212700,1895308,5406,2670,2670,0,2670,2411,259,5406,5406,0,0,5406,5378,5217,52,7,83,0,19,28,28,0,0,0,0,5406,46,5360,5406,2511,2895,5217,42,212700
42,79,212800,1715871,3598,1667,1667,0,1667,1578,89,3598,3598,0,0,3598,3580,3507,15,0,56,0,2,18,18,0,0,0,0,3598,8,3590,3598,1644,1954,3507,42,212800
42,79,212900,533642,1449,669,669,0,669,615,54,1449,1449,0,0,1449,1441,1409,10,2,18,0,2,8,8,0,0,0,0,1449,15,1434,1449,670,779,1409,42,212900
42,79,213000,435829,1507,738,738,0,738,693,45,1507,1507,0,0,1507,1500,1456,12,0,21,0,11,7,5,2,0,0,0,1507,22,1485,1507,688,819,1456,42,213000
42,79,213100,972857,1895,811,811,0,811,768,43,1895,1895,0,0,1895,1887,1828,17,1,34,1,6,8,8,0,0,0,0,1895,20,1875,1895,807,1088,1828,42,213100
42,79,213200,3049151,4984,2587,2587,0,2587,2345,242,4984,4984,0,0,4984,4932,4756,128,15,15,0,18,52,47,0,5,0,0,4984,59,4925,4984,2196,2788,4756,42,213200
42,79,213300,3860180,1782,787,787,0,787,747,40,1782,1782,0,0,1782,1781,1779,0,0,2,0,0,1,1,0,0,0,0,1782,10,1772,1782,861,921,1779,42,213300
42,79,213400,12329879,4694,1939,1939,0,1939,1808,131,4694,4694,0,0,4694,4678,4644,13,2,13,0,6,16,16,0,0,0,0,4694,33,4661,4694,2279,2415,4644,42,213400
42,79,213600,905086,2407,1271,1271,0,1271,1064,207,2407,2407,0,0,2407,2398,2352,34,3,3,0,6,9,9,0,0,0,0,2407,16,2391,2407,1098,1309,2352,42,213600
42,79,213700,1020579,2406,1130,1130,0,1130,993,137,2406,2406,0,0,2406,2395,2377,7,5,1,0,5,11,10,1,0,0,0,2406,17,2389,2406,1140,1266,2377,42,213700
42,79,213800,919108,1694,859,859,0,859,737,122,1694,1694,0,0,1694,1692,1676,8,2,3,0,3,2,2,0,0,0,0,1694,19,1675,1694,775,919,1676,42,213800
42,79,213900,40177463,2097,899,899,0,899,821,78,2097,2097,0,0,2097,2087,2080,2,0,2,0,3,10,10,0,0,0,0,2097,7,2090,2097,1054,1043,2080,42,213900
42,79,214000,2916232,1317,667,667,0,667,562,105,1317,1317,0,0,1317,1311,1303,1,1,1,0,5,6,6,0,0,0,0,1317,12,1305,1317,636,681,1303,42,214000
42,79,214100,904909,2622,1401,1401,0,1401,1230,171,2622,2622,0,0,2622,2609,2583,8,5,8,0,5,13,11,2,0,0,0,2622,14,2608,2622,1204,1418,2583,42,214100
42,79,214200,1157760,2744,1434,1434,0,1434,1278,156,2744,2744,0,0,2744,2739,2714,10,2,7,0,6,5,4,1,0,0,0,2744,13,2731,2744,1264,1480,2714,42,214200
42,79,214300,2641974,2067,962,962,0,962,859,103,2067,2067,0,0,2067,2063,2046,7,3,5,1,1,4,4,0,0,0,0,2067,6,2061,2067,969,1098,2046,42,214300
42,79,214400,1461624,2205,1023,1023,0,1023,921,102,2205,2205,0,0,2205,2193,2182,4,0,7,0,0,12,11,1,0,0,0,2205,4,2201,2205,1043,1162,2182,42,214400
42,79,214500,2474318,1753,856,856,0,856,788,68,1753,1753,0,0,1753,1748,1737,10,0,1,0,0,5,5,0,0,0,0,1753,8,1745,1753,820,933,1737,42,214500
42,79,214600,7165612,4190,1952,1952,0,1952,1814,138,4190,4190,0,0,4190,4148,4092,38,1,13,0,4,42,42,0,0,0,0,4190,29,4161,4190,1928,2262,4092,42,214600
42,79,214700,4614458,2938,1348,1348,0,1348,1259,89,2938,2938,0,0,2938,2925,2865,50,0,5,0,5,13,13,0,0,0,0,2938,23,2915,2938,1320,1618,2865,42,214700
42,79,214800,8665386,1067,489,489,0,489,444,45,1067,1067,0,0,1067,1062,1054,6,1,0,0,1,5,5,0,0,0,0,1067,5,1062,1067,489,578,1054,42,214800
42,79,214900,25817673,1540,693,693,0,693,646,47,1540,1540,0,0,1540,1531,1520,6,0,1,0,4,9,9,0,0,0,0,1540,4,1536,1540,762,778,1520,42,214900
42,79,215000,4646757,1647,744,744,0,744,674,70,1647,1647,0,0,1647,1639,1634,2,0,2,0,1,8,6,2,0,0,0,1647,8,1639,1647,781,866,1634,42,215000
42,79,215100,2390491,2866,1386,1386,0,1386,1245,141,2866,2866,0,0,2866,2844,2822,11,1,7,0,3,22,22,0,0,0,0,2866,12,2854,2866,1337,1529,2822,42,215100
42,79,215200,7664253,3235,1572,1572,0,1572,1455,117,3235,3235,0,0,3235,3209,3006,76,7,117,0,3,26,25,1,0,0,0,3235,25,3210,3235,1554,1681,3006,42,215200
42,79,215300,233345863,3983,1894,1894,0,1894,1550,344,3983,3983,0,0,3983,3972,3948,10,2,10,0,2,11,10,1,0,0,0,3983,24,3959,3983,2043,1940,3948,42,215300
42,79,215400,97992767,2359,1229,1229,0,1229,961,268,2359,2359,0,0,2359,2351,2328,2,3,15,0,3,8,8,0,0,0,0,2359,20,2339,2359,1154,1205,2328,42,215400
42,79,215501,25226960,3995,1502,1502,0,1502,1450,52,3995,3995,0,0,3995,3969,3842,33,2,84,0,8,26,26,0,0,0,0,3995,42,3953,3995,1923,2072,3842,42,215501
42,79,215502,33809913,5593,2071,2071,0,2071,2005,66,5593,5593,0,0,5593,5561,5402,31,2,111,0,15,32,30,2,0,0,0,5593,66,5527,5593,2745,2848,5402,42,215502
42,79,215503,28696552,2460,950,950,0,950,907,43,2460,2460,0,0,2460,2449,2378,12,0,50,0,9,11,10,1,0,0,0,2460,41,2419,2460,1189,1271,2378,42,215503
42,79,215504,91745217,3892,1621,1621,0,1621,1453,168,3892,3892,0,0,3892,3876,3861,6,0,5,0,4,16,12,4,0,0,0,3892,18,3874,3892,1951,1941,3861,42,215504
42,79,215600,42363149,5006,2166,2166,0,2166,1789,377,5006,5006,0,0,5006,4991,4514,429,6,15,0,27,15,15,0,0,0,0,5006,115,4891,5006,2808,2198,4514,42,215600
42,79,215701,55128350,2568,988,988,0,988,952,36,2568,2568,0,0,2568,2553,2538,3,1,11,0,0,15,14,1,0,0,0,2568,1,2567,2568,1308,1260,2538,42,215701
42,79,215702,51541693,2100,857,857,0,857,769,88,2100,2100,0,0,2100,2095,2085,3,2,5,0,0,5,5,0,0,0,0,2100,11,2089,2100,1066,1034,2085,42,215702
42,79,215800,111986122,2742,1258,1258,0,1258,1041,217,2742,2742,0,0,2742,2724,2721,1,0,1,0,1,18,15,3,0,0,0,2742,13,2729,2742,1387,1355,2721,42,215800
42,79,215900,199881133,3545,1587,1587,0,1587,1356,231,3545,3545,0,0,3545,3518,3481,13,14,6,1,3,27,21,6,0,0,0,3545,20,3525,3545,1776,1769,3481,42,215900
42,79,216000,958546,959,478,478,0,478,415,63,959,959,0,0,959,951,949,0,0,0,0,2,8,8,0,0,0,0,959,1,958,959,449,510,949,42,216000
42,79,216100,75123215,4269,1924,1924,0,1924,1743,181,4269,4269,0,0,4269,4255,4210,20,1,13,0,11,14,14,0,0,0,0,4269,28,4241,4269,2107,2162,4210,42,216100
42,79,216200,130791250,5252,2345,2345,0,2345,2125,220,5252,5252,0,0,5252,5222,5160,22,8,15,4,13,30,30,0,0,0,0,5252,40,5212,5252,2587,2665,5160,42,216200
42,79,216400,63335594,2132,965,965,0,965,832,133,2132,2132,0,0,2132,2130,2114,11,2,1,0,2,2,2,0,0,0,0,2132,10,2122,2132,1100,1032,2114,42,216400
42,79,216501,2763897,1958,817,817,0,817,793,24,1958,1958,0,0,1958,1952,1907,1,0,44,0,0,6,6,0,0,0,0,1958,14,1944,1958,926,1032,1907,42,216501
42,79,216502,56759431,3652,1302,1302,0,1302,1222,80,3652,3652,0,0,3652,3639,3580,10,4,37,0,8,13,13,0,0,0,0,3652,26,3626,3652,1878,1774,3580,42,216502
42,79,216600,86225457,7166,2747,2747,0,2747,2523,224,7166,7166,0,0,7166,7124,6642,406,11,36,1,28,42,36,4,2,0,0,7166,128,7038,7166,3585,3581,6642,42,216600
42,79,216700,1804078,3643,1847,1847,0,1847,1611,236,3643,3643,0,0,3643,3634,3590,4,2,26,0,12,9,9,0,0,0,0,3643,35,3608,3643,1693,1950,3590,42,216700
42,79,216800,116894596,3467,1723,1723,0,1723,1329,394,3467,3467,0,0,3467,3456,3403,37,1,8,0,7,11,11,0,0,0,0,3467,26,3441,3467,1752,1715,3403,42,216800
42,79,216900,44651898,4245,1814,1814,0,1814,1709,105,4245,4245,0,0,4245,4236,4218,4,0,8,0,6,9,6,3,0,0,0,4245,21,4224,4245,2105,2140,4218,42,216900
42,79,217001,63470512,1895,933,933,0,933,845,88,1895,1895,0,0,1895,1888,1874,3,0,7,0,4,7,7,0,0,0,0,1895,10,1885,1895,931,964,1874,42,217001
42,79,217002,8229665,2860,1255,1255,0,1255,1221,34,2860,2860,0,0,2860,2842,2788,8,5,13,0,28,18,16,2,0,0,0,2860,61,2799,2860,1232,1628,2788,42,217002
42,79,217100,1110735,3151,1594,1594,0,1594,1434,160,3151,3151,0,0,3151,3137,3087,16,0,8,0,26,14,14,0,0,0,0,3151,52,3099,3151,1471,1680,3087,42,217100
42,79,217200,2205474,2850,1538,1538,0,1538,1323,215,2850,2850,0,0,2850,2813,2661,30,4,21,0,97,37,37,0,0,0,0,2850,189,2661,2850,1309,1541,2661,42,217200
42,79,217300,5935730,3652,1548,1548,0,1548,1449,99,3652,3652,0,0,3652,3639,3567,7,4,50,0,11,13,13,0,0,0,0,3652,35,3617,3652,1696,1956,3567,42,217300
42,79,217400,2949472,1624,776,776,0,776,714,62,1624,1624,0,0,1624,1590,1451,37,2,12,0,88,34,34,0,0,0,0,1624,158,1466,1624,774,850,1451,42,217400
42,79,217500,577193,2242,1164,1164,0,1164,946,218,2242,2242,0,0,2242,2214,1944,29,6,13,2,220,28,26,1,0,1,0,2242,316,1926,2242,1103,1139,1944,42,217500
42,79,217600,501663,2460,1299,1299,0,1299,1114,185,2460,2460,0,0,2460,2436,2314,19,13,19,0,71,24,24,0,0,0,0,2460,121,2339,2460,1160,1300,2314,42,217600
42,79,217700,1431427,4351,2164,2164,0,2164,1968,196,4351,4351,0,0,4351,4322,4174,41,9,15,1,82,29,29,0,0,0,0,4351,155,4196,4351,2027,2324,4174,42,217700
42,79,217800,762822,2999,1473,1473,0,1473,1333,140,2999,2999,0,0,2999,2971,2894,13,0,14,0,50,28,23,0,5,0,0,2999,106,2893,2999,1358,1641,2894,42,217800
42,79,217900,4018004,3542,1834,1834,0,1834,1634,200,3542,3542,0,0,3542,3527,3461,20,2,8,0,36,15,15,0,0,0,0,3542,79,3463,3542,1705,1837,3461,42,217900
42,81,100,2614164,3254,1459,1459,0,1459,1400,59,3254,3254,0,0,3254,3208,3031,124,7,33,1,12,46,40,6,0,0,0,3254,36,3218,3254,1515,1739,3031,42,100
42,81,200,1775987,2283,987,987,0,987,932,55,2283,2283,0,0,2283,2256,2073,146,5,25,0,7,27,21,6,0,0,0,2283,15,2268,2283,1110,1173,2073,42,200
42,81,300,2163308,5973,2799,2799,0,2799,2485,314,5973,5973,0,0,5973,5863,5046,750,30,16,0,21,110,106,4,0,0,0,5973,81,5892,5973,2925,3048,5046,42,300
42,81,400,1286518,5046,2590,2590,0,2590,2275,315,5046,5046,0,0,5046,4915,3213,1600,28,17,0,57,131,117,14,0,0,0,5046,76,4970,5046,2366,2680,3213,42,400
42,81,500,899714,3036,986,986,0,986,878,108,3036,3036,0,0,3036,3003,2736,217,1,31,2,16,33,29,4,0,0,0,3036,28,3008,3036,1443,1593,2736,42,500
42,81,600,1908405,3058,1490,1490,0,1490,1259,231,3058,3058,0,0,3058,3010,2643,328,17,11,0,11,48,41,4,3,0,0,3058,34,3024,3058,1674,1384,2643,42,600
42,81,800,2523827,2140,611,611,0,611,563,48,2140,2140,0,0,2140,2118,1814,287,2,1,0,14,22,22,0,0,0,0,2140,26,2114,2140,1430,710,1814,42,800
42,81,900,5654544,2617,1121,1121,0,1121,1046,75,2617,2617,0,0,2617,2563,2431,104,11,13,1,3,54,54,0,0,0,0,2617,7,2610,2617,1192,1425,2431,42,900
42,81,1000,4183353,3299,1481,1481,0,1481,1381,100,3299,3299,0,0,3299,3238,2840,354,10,28,0,6,61,60,1,0,0,0,3299,37,3262,3299,1520,1779,2840,42,1000
42,81,10100,679173789,2467,1509,1509,0,1509,946,563,2467,2467,0,0,2467,2461,2434,13,12,0,1,1,6,6,0,0,0,0,2467,9,2458,2467,1239,1228,2434,42,10100
42,81,10200,625227921,1161,1552,1552,0,1552,508,1044,1161,1161,0,0,1161,1153,1150,2,0,0,0,1,8,8,0,0,0,0,1161,4,1157,1161,608,553,1150,42,10200
42,81,10300,140800128,3568,1413,1413,0,1413,1302,111,3568,3568,0,0,3568,3552,3537,3,3,9,0,0,16,16,0,0,0,0,3568,6,3562,3568,1798,1770,3537,42,10300
42,81,10400,180611678,5581,2368,2368,0,2368,2147,221,5581,5581,0,0,5581,5539,5497,20,4,18,0,0,42,42,0,0,0,0,5581,17,5564,5581,2802,2779,5497,42,10400
42,81,10500,450836141,6076,2662,2662,0,2662,2266,396,6076,6076,0,0,6076,6055,6015,12,12,11,0,5,21,18,3,0,0,0,6076,19,6057,6076,3044,3032,6015,42,10500
42,81,10600,294750761,4392,1951,1951,0,1951,1674,277,4392,4392,0,0,4392,4382,4367,6,5,4,0,0,10,10,0,0,0,0,4392,0,4392,4392,2256,2136,4367,42,10600
42,81,10700,82673885,5962,2572,2572,0,2572,2413,159,5962,5962,0,0,5962,5925,5885,10,14,8,0,8,37,36,1,0,0,0,5962,26,5936,5962,2933,3029,5885,42,10700
42,81,10800,94821839,7209,3123,3123,0,3123,2920,203,7209,7209,0,0,7209,7164,7096,8,16,31,0,13,45,41,3,0,1,0,7209,40,7169,7209,3444,3765,7096,42,10800
42,81,10900,30096896,2659,1100,1100,0,1100,1020,80,2659,2659,0,0,2659,2640,2605,16,8,10,0,1,19,16,3,0,0,0,2659,14,2645,2659,1294,1365,2605,42,10900
42,81,11000,10475759,4777,2169,2169,0,2169,2067,102,4777,4777,0,0,4777,4757,4730,5,3,16,0,3,20,20,0,0,0,0,4777,20,4757,4777,2270,2507,4730,42,11000
42,81,11100,8714189,5641,2648,2648,0,2648,2534,114,5641,5641,0,0,5641,5577,5248,242,5,48,1,33,64,58,6,0,0,0,5641,71,5570,5641,2478,3163,5248,42,11100
42,81,11200,45703761,5235,2039,2039,0,2039,1967,72,5235,5235,0,0,5235,5187,5064,45,9,66,0,3,48,48,0,0,0,0,5235,22,5213,5235,2408,2827,5064,42,11200
42,81,11300,58534182,7905,3379,3379,0,3379,3226,153,7905,7905,0,0,7905,7855,7719,64,13,47,0,12,50,45,5,0,0,0,7905,17,7888,7905,3932,3973,7719,42,11300
42,81,11400,83264509,1710,765,765,0,765,694,71,1710,1710,0,0,1710,1703,1696,4,3,0,0,0,7,7,0,0,0,0,1710,6,1704,1710,833,877,1696,42,11400
42,81,11600,6309903,7692,3442,3442,0,3442,3275,167,7692,7692,0,0,7692,7656,7594,30,9,19,2,2,36,35,1,0,0,0,7692,37,7655,7692,3744,3948,7594,42,11600
42,81,11700,221915427,7749,2453,2453,0,2453,2251,202,7749,7749,0,0,7749,7720,6837,774,19,23,0,67,29,29,0,0,0,0,7749,120,7629,7749,3826,3923,6837,42,11700
42,81,11800,138361082,3439,1229,1229,0,1229,1161,68,3439,3439,0,0,3439,3419,3400,1,3,5,0,10,20,19,1,0,0,0,3439,22,3417,3439,1770,1669,3400,42,11800
42,81,11900,22973938,6115,2566,2566,0,2566,2413,153,6115,6115,0,0,6115,6098,6036,24,9,19,4,6,17,17,0,0,0,0,6115,9,6106,6115,2828,3287,6036,42,11900
42,83,420100,94513190,3712,1635,1635,0,1635,1519,116,3712,3712,0,0,3712,3698,3654,3,15,23,0,3,14,14,0,0,0,0,3712,13,3699,3712,1802,1910,3654,42,420100
42,83,420200,2880666,3355,1748,1748,0,1748,1538,210,3355,3355,0,0,3355,3337,3294,12,12,6,1,12,18,16,2,0,0,0,3355,34,3321,3355,1596,1759,3294,42,420200
42,83,420300,1514729,2758,1246,1246,0,1246,1120,126,2758,2758,0,0,2758,2739,2694,12,8,12,2,11,19,15,4,0,0,0,2758,26,2732,2758,1257,1501,2694,42,420300
42,83,420400,4539284,3062,1377,1377,0,1377,1264,113,3062,3062,0,0,3062,3041,2980,21,8,30,0,2,21,21,0,0,0,0,3062,27,3035,3062,1451,1611,2980,42,420400
42,83,420500,121183572,3325,1384,1384,0,1384,1291,93,3325,3325,0,0,3325,3316,3288,8,10,6,0,4,9,9,0,0,0,0,3325,12,3313,3325,1638,1687,3288,42,420500
42,83,420600,362517603,6016,2737,2737,0,2737,2384,353,6016,6016,0,0,6016,5985,5948,7,23,5,0,2,31,31,0,0,0,0,6016,9,6007,6016,2955,3061,5948,42,420600
42,83,420700,319092326,4787,2246,2246,0,2246,1887,359,4787,4787,0,0,4787,4758,4721,4,15,3,1,14,29,29,0,0,0,0,4787,17,4770,4787,2384,2403,4721,42,420700
42,83,420800,399053727,4152,2086,2086,0,2086,1573,513,4152,4152,0,0,4152,4128,4100,11,4,4,6,3,24,23,1,0,0,0,4152,28,4124,4152,2044,2108,4100,42,420800
42,83,420900,458306095,2504,1817,1817,0,1817,1058,759,2504,2504,0,0,2504,2496,2485,1,3,3,0,4,8,6,2,0,0,0,2504,14,2490,2504,1269,1235,2485,42,420900
42,83,421000,367236625,5745,1835,1835,0,1835,1614,221,5745,5745,0,0,5745,5666,4687,774,46,40,0,119,79,74,4,0,1,0,5745,266,5479,5745,3474,2271,4687,42,421000
42,83,421100,299494113,3955,2298,2298,0,2298,1726,572,3955,3955,0,0,3955,3932,3911,2,3,5,0,11,23,19,4,0,0,0,3955,28,3927,3955,1871,2084,3911,42,421100
42,83,421200,111913968,2565,1235,1235,0,1235,1050,185,2565,2565,0,0,2565,2561,2550,5,2,2,1,1,4,4,0,0,0,0,2565,11,2554,2565,1272,1293,2550,42,421200
42,85,30100,1235868,2524,1136,1136,0,1136,1008,128,2524,2524,0,0,2524,2474,2311,138,7,13,0,5,50,45,5,0,0,0,2524,24,2500,2524,1269,1255,2311,42,30100
42,85,30200,2261663,751,602,602,0,602,537,65,751,751,0,0,751,731,561,165,3,1,0,1,20,13,7,0,0,0,751,2,749,751,269,482,561,42,30200
42,85,30300,1887245,4267,1858,1858,0,1858,1699,159,4267,4267,0,0,4267,4183,3956,203,6,10,0,8,84,79,3,2,0,0,4267,34,4233,4267,2042,2225,3956,42,30300
42,85,30400,2124109,3027,1221,1221,0,1221,1163,58,3027,3027,0,0,3027,3000,2956,37,2,4,1,0,27,27,0,0,0,0,3027,25,3002,3027,1393,1634,2956,42,30400
42,85,30500,1239696,2680,1256,1256,0,1256,1174,82,2680,2680,0,0,2680,2628,2258,354,5,2,2,7,52,46,6,0,0,0,2680,22,2658,2680,1260,1420,2258,42,30500
42,85,30600,989673,3079,1315,1315,0,1315,1210,105,3079,3079,0,0,3079,2973,2072,874,6,4,1,16,106,96,10,0,0,0,3079,37,3042,3079,1423,1656,2072,42,30600
42,85,30700,2551060,1310,589,589,0,589,502,87,1310,1310,0,0,1310,1265,320,940,1,0,0,4,45,33,2,10,0,0,1310,6,1304,1310,602,708,320,42,30700
42,85,30800,900145,1656,727,727,0,727,622,105,1656,1656,0,0,1656,1599,428,1158,1,10,0,2,57,50,7,0,0,0,1656,15,1641,1656,722,934,428,42,30800
42,85,30900,2678501,3102,1445,1445,0,1445,1389,56,3102,3102,0,0,3102,3060,2309,731,5,2,1,12,42,40,2,0,0,0,3102,19,3083,3102,1378,1724,2309,42,30900
42,85,31000,2285059,748,379,379,0,379,349,30,748,748,0,0,748,735,643,90,0,1,0,1,13,13,0,0,0,0,748,8,740,748,344,404,643,42,31000
42,85,31100,9690007,1871,774,774,0,774,744,30,1871,1871,0,0,1871,1846,1602,236,1,1,0,6,25,23,2,0,0,0,1871,8,1863,1871,837,1034,1602,42,31100
42,85,31200,30130575,5147,2157,2157,0,2157,2085,72,5147,5147,0,0,5147,5127,5013,63,2,40,0,9,20,19,1,0,0,0,5147,27,5120,5147,2457,2690,5013,42,31200
42,85,31300,22816370,2563,1089,1089,0,1089,1048,41,2563,2563,0,0,2563,2551,2508,12,2,25,0,4,12,12,0,0,0,0,2563,21,2542,2563,1266,1297,2508,42,31300
42,85,31400,8965402,5411,2582,2582,0,2582,2456,126,5411,5411,0,0,5411,5364,5211,74,2,61,0,16,47,41,6,0,0,0,5411,39,5372,5411,2452,2959,5211,42,31400
42,85,31500,4644876,1147,493,493,0,493,467,26,1147,1147,0,0,1147,1113,995,112,0,3,1,2,34,29,5,0,0,0,1147,12,1135,1147,538,609,995,42,31500
42,85,31600,1762691,1955,915,915,0,915,854,61,1955,1955,0,0,1955,1930,1833,84,4,6,0,3,25,23,2,0,0,0,1955,19,1936,1955,896,1059,1833,42,31600
42,85,31700,1829744,2545,1101,1101,0,1101,1058,43,2545,2545,0,0,2545,2540,2496,20,2,12,0,10,5,5,0,0,0,0,2545,22,2523,2545,1218,1327,2496,42,31700
42,85,31800,244732173,5092,2093,2093,0,2093,1937,156,5092,5092,0,0,5092,5069,5038,12,7,6,3,3,23,21,2,0,0,0,5092,15,5077,5092,2562,2530,5038,42,31800
42,85,31900,68473475,4913,2023,2023,0,2023,1953,70,4913,4913,0,0,4913,4890,4841,14,9,22,0,4,23,23,0,0,0,0,4913,22,4891,4913,2368,2545,4841,42,31900
42,85,32000,154661336,5354,2222,2222,0,2222,2035,187,5354,5354,0,0,5354,5321,5298,10,4,8,0,1,33,33,0,0,0,0,5354,14,5340,5354,2613,2741,5298,42,32000
42,85,32100,2970111,3379,1372,1372,0,1372,1224,148,3379,3379,0,0,3379,3345,3203,95,4,37,1,5,34,33,1,0,0,0,3379,23,3356,3379,1640,1739,3203,42,32100
42,85,32200,2066409,3001,1351,1351,0,1351,1240,111,3001,3001,0,0,3001,2989,2943,18,4,15,1,8,12,12,0,0,0,0,3001,8,2993,3001,1375,1626,2943,42,32200
42,85,32300,57939000,3490,1401,1401,0,1401,1358,43,3490,3490,0,0,3490,3478,3453,13,0,8,0,4,12,10,2,0,0,0,3490,12,3478,3490,1705,1785,3453,42,32300
42,85,32400,127896872,6593,2746,2746,0,2746,2577,169,6593,6593,0,0,6593,6560,6505,26,7,9,0,13,33,32,1,0,0,0,6593,33,6560,6593,3275,3318,6505,42,32400
42,85,32501,253553888,6205,2539,2539,0,2539,2352,187,6205,6205,0,0,6205,6172,6148,12,2,7,0,3,33,33,0,0,0,0,6205,16,6189,6205,3053,3152,6148,42,32501
42,85,32502,111478876,2257,928,928,0,928,852,76,2257,2257,0,0,2257,2248,2241,0,2,1,2,2,9,7,2,0,0,0,2257,14,2243,2257,1119,1138,2241,42,32502
42,85,32601,168166537,6404,2519,2519,0,2519,2360,159,6404,6404,0,0,6404,6364,6289,32,12,20,1,10,40,40,0,0,0,0,6404,48,6356,6404,3142,3262,6289,42,32601
42,85,32602,57923764,4696,1650,1650,0,1650,1562,88,4696,4696,0,0,4696,4669,4255,393,7,6,2,6,27,27,0,0,0,0,4696,112,4584,4696,2824,1872,4255,42,32602
42,85,32701,79825167,4966,2091,2091,0,2091,2009,82,4966,4966,0,0,4966,4944,4844,74,3,13,0,10,22,21,1,0,0,0,4966,20,4946,4966,2408,2558,4844,42,32701
42,85,32702,53758291,2561,952,952,0,952,909,43,2561,2561,0,0,2561,2552,2503,22,8,5,1,13,9,8,1,0,0,0,2561,20,2541,2561,1278,1283,2503,42,32702
42,85,32800,109538568,5138,1862,1862,0,1862,1771,91,5138,5138,0,0,5138,5099,4825,231,2,34,3,4,39,36,3,0,0,0,5138,46,5092,5138,2764,2374,4825,42,32800
42,85,32900,3341691,3183,1424,1424,0,1424,1333,91,3183,3183,0,0,3183,3160,3083,31,1,38,3,4,23,23,0,0,0,0,3183,16,3167,3183,1474,1709,3083,42,32900
42,85,33000,3659696,4925,1370,1370,0,1370,1286,84,4925,4925,0,0,4925,4889,4796,32,4,50,0,7,36,35,1,0,0,0,4925,28,4897,4925,2381,2544,4796,42,33000
42,85,33100,142016762,4353,1677,1677,0,1677,1589,88,4353,4353,0,0,4353,4325,4294,12,2,12,4,1,28,28,0,0,0,0,4353,16,4337,4353,2176,2177,4294,42,33100
42,87,960100,240283342,3988,1956,1956,0,1956,1532,424,3988,3988,0,0,3988,3968,3940,3,0,17,0,8,20,20,0,0,0,0,3988,28,3960,3988,2012,1976,3940,42,960100
42,87,960200,85871274,3852,1523,1523,0,1523,1403,120,3852,3852,0,0,3852,3840,3804,14,5,16,0,1,12,12,0,0,0,0,3852,8,3844,3852,1884,1968,3804,42,960200
42,87,960300,127838993,5076,1793,1793,0,1793,1647,146,5076,5076,0,0,5076,5058,5008,36,2,4,0,8,18,18,0,0,0,0,5076,17,5059,5076,2380,2696,5008,42,960300
42,87,960400,128159671,3030,1485,1485,0,1485,1181,304,3030,3030,0,0,3030,3019,2999,10,0,3,0,7,11,11,0,0,0,0,3030,16,3014,3030,1469,1561,2999,42,960400
42,87,960500,174639742,3724,1749,1749,0,1749,1454,295,3724,3724,0,0,3724,3715,3705,6,0,3,0,1,9,9,0,0,0,0,3724,6,3718,3724,1834,1890,3705,42,960500
42,87,960600,104334707,5397,2343,2343,0,2343,2194,149,5397,5397,0,0,5397,5376,5325,24,10,12,0,5,21,21,0,0,0,0,5397,24,5373,5397,2675,2722,5325,42,960600
42,87,960700,1178297,2503,1262,1262,0,1262,1142,120,2503,2503,0,0,2503,2480,2426,25,6,12,1,10,23,22,1,0,0,0,2503,26,2477,2503,1116,1387,2426,42,960700
42,87,960800,2103198,4027,2003,2003,0,2003,1742,261,4027,4027,0,0,4027,4000,3915,48,11,3,1,22,27,26,1,0,0,0,4027,65,3962,4027,1897,2130,3915,42,960800
42,87,960900,1936459,2468,1250,1250,0,1250,1139,111,2468,2468,0,0,2468,2459,2433,13,1,11,0,1,9,9,0,0,0,0,2468,11,2457,2468,1076,1392,2433,42,960900
42,87,961000,2759397,2144,983,983,0,983,919,64,2144,2144,0,0,2144,2137,2127,7,0,3,0,0,7,7,0,0,0,0,2144,7,2137,2144,1041,1103,2127,42,961000
42,87,961100,80551972,7256,3161,3161,0,3161,2946,215,7256,7256,0,0,7256,7223,7136,22,1,46,0,18,33,32,1,0,0,0,7256,43,7213,7256,3480,3776,7136,42,961100
42,87,961200,117048858,3021,1237,1237,0,1237,1114,123,3021,3021,0,0,3021,3012,2985,18,2,5,0,2,9,9,0,0,0,0,3021,12,3009,3021,1556,1465,2985,42,961200
42,89,300101,64833201,2649,1270,1270,0,1270,925,345,2649,2649,0,0,2649,2613,2413,138,4,31,0,27,36,32,3,1,0,0,2649,103,2546,2649,1361,1288,2413,42,300101
42,89,300102,53868136,5686,2562,2562,0,2562,1955,607,5686,5686,0,0,5686,5569,4885,421,6,45,0,212,117,114,3,0,0,0,5686,463,5223,5686,2834,2852,4885,42,300102
42,89,300103,83749608,5809,3459,3459,0,3459,2018,1441,5809,5809,0,0,5809,5652,4913,460,19,106,1,153,157,144,11,2,0,0,5809,527,5282,5809,2987,2822,4913,42,300103
42,89,300200,200643008,9293,4709,4709,0,4709,3603,1106,9293,9293,0,0,9293,9146,8424,471,21,78,1,151,147,142,5,0,0,0,9293,424,8869,9293,4540,4753,8424,42,300200
42,89,300301,124523691,3583,3157,3157,0,3157,1416,1741,3583,3583,0,0,3583,3522,3240,168,11,22,7,74,61,60,1,0,0,0,3583,280,3303,3583,1788,1795,3240,42,300301
42,89,300302,97537586,11622,6219,6219,0,6219,3685,2534,11622,11622,0,0,11622,11069,7643,2216,32,132,4,1042,553,531,22,0,0,0,11622,2047,9575,11622,5726,5896,7643,42,300302
42,89,300303,130599795,6152,6199,6199,0,6199,2420,3779,6152,6152,0,0,6152,6061,5681,245,23,37,1,74,91,91,0,0,0,0,6152,312,5840,6152,3048,3104,5681,42,300303
42,89,300304,100062397,4983,2967,2967,0,2967,1661,1306,4983,4983,0,0,4983,4841,4310,352,12,47,1,119,142,142,0,0,0,0,4983,472,4511,4983,2528,2455,4310,42,300304
42,89,300401,50352534,3943,2047,2047,0,2047,1517,530,3943,3943,0,0,3943,3889,3710,87,3,33,4,52,54,48,6,0,0,0,3943,160,3783,3943,1976,1967,3710,42,300401
42,89,300402,38258584,5664,2203,2203,0,2203,1986,217,5664,5664,0,0,5664,5536,4956,307,11,95,3,164,128,114,10,4,0,0,5664,388,5276,5664,2779,2885,4956,42,300402
42,89,300403,76119069,5979,2744,2744,0,2744,2128,616,5979,5979,0,0,5979,5898,5485,201,18,72,7,115,81,71,10,0,0,0,5979,276,5703,5979,2936,3043,5485,42,300403
42,89,300500,60036786,5672,3028,3028,0,3028,2084,944,5672,5672,0,0,5672,5548,4979,319,25,54,1,170,124,116,8,0,0,0,5672,419,5253,5672,2832,2840,4979,42,300500
42,89,300600,4182113,4330,1779,1779,0,1779,1691,88,4330,4330,0,0,4330,4193,3769,249,8,70,1,96,137,125,12,0,0,0,4330,282,4048,4330,2097,2233,3769,42,300600
42,89,300700,3250550,5558,1552,1552,0,1552,1454,98,5558,5558,0,0,5558,5461,4912,369,14,84,0,82,97,92,5,0,0,0,5558,268,5290,5558,2475,3083,4912,42,300700
42,89,300800,4594050,5756,2630,2630,0,2630,2422,208,5756,5756,0,0,5756,5607,4985,371,12,109,0,130,149,134,14,1,0,0,5756,400,5356,5756,2675,3081,4985,42,300800
42,89,300900,13679930,5132,2131,2131,0,2131,2055,76,5132,5132,0,0,5132,5064,4648,225,10,101,0,80,68,67,1,0,0,0,5132,231,4901,5132,2535,2597,4648,42,300900
42,89,301000,71602546,9590,4166,4166,0,4166,3464,702,9590,9590,0,0,9590,9365,8108,765,17,140,2,333,225,202,20,3,0,0,9590,835,8755,9590,4718,4872,8108,42,301000
42,89,301100,99196277,8235,3299,3299,0,3299,2947,352,8235,8235,0,0,8235,8166,7817,200,8,82,4,55,69,66,3,0,0,0,8235,229,8006,8235,4158,4077,7817,42,301100
42,89,301201,62282684,10061,3905,3905,0,3905,3362,543,10061,10061,0,0,10061,9909,9174,486,15,104,2,128,152,141,11,0,0,0,10061,579,9482,10061,5081,4980,9174,42,301201
42,89,301202,34725022,4357,1688,1688,0,1688,1544,144,4357,4357,0,0,4357,4305,4139,100,4,40,1,21,52,49,3,0,0,0,4357,124,4233,4357,2119,2238,4139,42,301202
42,89,301203,58573080,5435,1974,1974,0,1974,1875,99,5435,5435,0,0,5435,5377,5251,59,4,21,0,42,58,52,6,0,0,0,5435,119,5316,5435,2754,2681,5251,42,301203
42,89,301301,80378417,6533,2824,2824,0,2824,2301,523,6533,6533,0,0,6533,6487,6296,120,13,37,0,21,46,42,4,0,0,0,6533,220,6313,6533,3214,3319,6296,42,301301
42,89,301302,62963182,2665,1069,1069,0,1069,941,128,2665,2665,0,0,2665,2643,2604,14,8,5,0,12,22,20,2,0,0,0,2665,37,2628,2665,1329,1336,2604,42,301302
42,91,200103,5288872,3541,1206,1206,0,1206,1189,17,3541,3541,0,0,3541,3527,3366,15,6,132,0,8,14,12,0,0,2,0,3541,43,3498,3541,1734,1807,3366,42,200103
42,91,200104,5761331,3913,1388,1388,0,1388,1376,12,3913,3913,0,0,3913,3887,3763,8,0,113,0,3,26,26,0,0,0,0,3913,26,3887,3913,1941,1972,3763,42,200104
42,91,200105,3974813,2264,826,826,0,826,816,10,2264,2264,0,0,2264,2257,2121,16,0,113,0,7,7,6,1,0,0,0,2264,17,2247,2264,1108,1156,2121,42,200105
42,91,200106,3846031,1563,789,789,0,789,731,58,1563,1563,0,0,1563,1554,1507,21,0,22,0,4,9,8,1,0,0,0,1563,17,1546,1563,681,882,1507,42,200106
42,91,200200,4952418,1351,381,381,0,381,377,4,1351,1351,0,0,1351,1343,1308,14,1,17,0,3,8,6,2,0,0,0,1351,9,1342,1351,658,693,1308,42,200200
42,91,200301,4052155,6077,2852,2852,0,2852,2780,72,6077,6077,0,0,6077,5995,5076,412,7,454,1,45,82,79,3,0,0,0,6077,153,5924,6077,2987,3090,5076,42,200301
42,91,200305,1233964,2058,805,805,0,805,755,50,2058,2058,0,0,2058,2052,2020,9,5,1,0,17,6,5,1,0,0,0,2058,40,2018,2058,976,1082,2020,42,200305
42,91,200306,4293786,3681,1445,1445,0,1445,1434,11,3681,3681,0,0,3681,3663,3554,44,1,37,2,25,18,15,3,0,0,0,3681,44,3637,3681,1828,1853,3554,42,200306
42,91,200307,1833174,3332,1336,1336,0,1336,1296,40,3332,3332,0,0,3332,3289,2891,323,0,64,2,9,43,36,7,0,0,0,3332,57,3275,3332,1452,1880,2891,42,200307
42,91,200308,1716655,4014,1768,1768,0,1768,1695,73,4014,4014,0,0,4014,3939,3492,229,4,171,1,42,75,68,7,0,0,0,4014,96,3918,4014,1941,2073,3492,42,200308
42,91,200309,953625,2697,985,985,0,985,965,20,2697,2697,0,0,2697,2681,2589,46,2,44,0,0,16,16,0,0,0,0,2697,17,2680,2697,1304,1393,2589,42,200309
42,91,200310,6534286,3134,1212,1212,0,1212,1195,17,3134,3134,0,0,3134,3113,3051,27,5,22,0,8,21,16,4,1,0,0,3134,25,3109,3134,1472,1662,3051,42,200310
42,91,200401,1949595,3456,1555,1555,0,1555,1507,48,3456,3456,0,0,3456,3436,3328,47,7,41,0,13,20,17,3,0,0,0,3456,42,3414,3456,1630,1826,3328,42,200401
42,91,200402,1720329,3937,1566,1566,0,1566,1534,32,3937,3937,0,0,3937,3917,3750,97,3,37,0,30,20,17,3,0,0,0,3937,65,3872,3937,1919,2018,3750,42,200402
42,91,200501,7914115,4053,1307,1307,0,1307,1298,9,4053,4053,0,0,4053,4032,3838,70,8,104,0,12,21,20,1,0,0,0,4053,36,4017,4053,2066,1987,3838,42,200501
42,91,200502,3381715,5554,2457,2457,0,2457,2372,85,5554,5554,0,0,5554,5479,4814,314,20,267,0,64,75,70,5,0,0,0,5554,137,5417,5554,2864,2690,4814,42,200502
42,91,200505,18176452,4799,1924,1924,0,1924,1874,50,4799,4799,0,0,4799,4757,4214,189,6,325,2,21,42,37,5,0,0,0,4799,97,4702,4799,2420,2379,4214,42,200505
42,91,200506,8129381,4528,1430,1430,0,1430,1415,15,4528,4528,0,0,4528,4497,4167,111,7,191,1,20,31,30,1,0,0,0,4528,60,4468,4528,2241,2287,4167,42,200506
42,91,200507,7272154,5298,2151,2151,0,2151,2123,28,5298,5298,0,0,5298,5246,4731,220,1,277,0,17,52,51,1,0,0,0,5298,57,5241,5298,2446,2852,4731,42,200507
42,91,200602,8502326,5873,2302,2302,0,2302,2258,44,5873,5873,0,0,5873,5820,4947,245,8,603,0,17,53,50,3,0,0,0,5873,79,5794,5873,2811,3062,4947,42,200602
42,91,200603,4191805,3353,1198,1198,0,1198,1183,15,3353,3353,0,0,3353,3320,3059,138,2,107,0,14,33,28,4,1,0,0,3353,64,3289,3353,1635,1718,3059,42,200603
42,91,200604,5466865,8158,2796,2796,0,2796,2772,24,8158,8158,0,0,8158,8080,6969,266,5,810,3,27,78,70,5,3,0,0,8158,87,8071,8158,4024,4134,6969,42,200604
42,91,200605,9435986,4641,1757,1757,0,1757,1713,44,4641,4641,0,0,4641,4589,3878,203,1,503,0,4,52,49,3,0,0,0,4641,49,4592,4641,2162,2479,3878,42,200605
42,91,200703,6496611,4070,1518,1518,0,1518,1486,32,4070,4070,0,0,4070,4035,3659,82,9,254,0,31,35,32,3,0,0,0,4070,81,3989,4070,2005,2065,3659,42,200703
42,91,200704,4009096,3320,1327,1327,0,1327,1266,61,3320,3320,0,0,3320,3290,3006,112,1,157,1,13,30,27,3,0,0,0,3320,52,3268,3320,1626,1694,3006,42,200704
42,91,200707,7917814,3961,1866,1866,0,1866,1710,156,3961,3961,0,0,3961,3789,2907,293,4,494,5,86,172,147,22,0,3,0,3961,167,3794,3961,2072,1889,2907,42,200707
42,91,200708,7378043,5361,1881,1881,0,1881,1840,41,5361,5361,0,0,5361,5285,4287,123,10,830,0,35,76,75,0,1,0,0,5361,100,5261,5361,2686,2675,4287,42,200708
42,91,200800,1644505,2605,1139,1139,0,1139,1106,33,2605,2605,0,0,2605,2547,2141,46,8,314,1,37,58,54,4,0,0,0,2605,87,2518,2605,1273,1332,2141,42,200800
42,91,200901,2183007,3990,1644,1644,0,1644,1563,81,3990,3990,0,0,3990,3892,3359,133,3,342,17,38,98,92,6,0,0,0,3990,116,3874,3990,1859,2131,3359,42,200901
42,91,200902,356749,1329,573,573,0,573,552,21,1329,1329,0,0,1329,1301,1168,65,0,57,1,10,28,28,0,0,0,0,1329,41,1288,1329,649,680,1168,42,200902
42,91,200903,2148882,3934,1871,1871,0,1871,1792,79,3934,3934,0,0,3934,3879,3305,167,4,379,0,24,55,49,6,0,0,0,3934,138,3796,3934,1944,1990,3305,42,200903
42,91,200906,1226709,2116,818,818,0,818,793,25,2116,2116,0,0,2116,2083,1626,92,4,351,0,10,33,33,0,0,0,0,2116,63,2053,2116,1016,1100,1626,42,200906
42,91,200907,982319,2656,1098,1098,0,1098,1069,29,2656,2656,0,0,2656,2625,2476,83,2,55,0,9,31,30,1,0,0,0,2656,45,2611,2656,1277,1379,2476,42,200907
42,91,200908,1037024,2046,889,889,0,889,851,38,2046,2046,0,0,2046,2019,1791,94,2,98,7,27,27,27,0,0,0,0,2046,63,1983,2046,993,1053,1791,42,200908
42,91,201003,6958770,4346,1830,1830,0,1830,1763,67,4346,4346,0,0,4346,4322,3715,222,6,354,0,25,24,22,2,0,0,0,4346,73,4273,4346,2093,2253,3715,42,201003
42,91,201004,3353157,4429,1869,1869,0,1869,1807,62,4429,4429,0,0,4429,4367,3734,160,4,447,0,22,62,60,2,0,0,0,4429,97,4332,4429,2006,2423,3734,42,201004
42,91,201005,5465117,3689,1206,1206,0,1206,1190,16,3689,3689,0,0,3689,3658,3291,108,1,252,0,6,31,31,0,0,0,0,3689,27,3662,3689,1825,1864,3291,42,201005
42,91,201006,5297705,1779,591,591,0,591,581,10,1779,1779,0,0,1779,1762,1618,76,0,63,0,5,17,13,0,4,0,0,1779,10,1769,1779,902,877,1618,42,201006
42,91,201100,1479939,3342,1330,1330,0,1330,1299,31,3342,3342,0,0,3342,3283,3018,161,2,70,6,26,59,55,3,0,1,0,3342,50,3292,3342,1666,1676,3018,42,201100
42,91,201201,13793645,5428,2161,2161,0,2161,2057,104,5428,5428,0,0,5428,5385,4884,150,4,330,0,17,43,37,6,0,0,0,5428,63,5365,5428,2502,2926,4884,42,201201
42,91,201203,7739385,2914,1271,1271,0,1271,1229,42,2914,2914,0,0,2914,2905,2775,65,1,61,1,2,9,9,0,0,0,0,2914,8,2906,2914,1256,1658,2775,42,201203
42,91,201204,2656001,2080,928,928,0,928,891,37,2080,2080,0,0,2080,2030,1387,596,3,36,0,8,50,35,15,0,0,0,2080,38,2042,2080,928,1152,1387,42,201204
42,91,201301,1136024,3357,1351,1351,0,1351,1311,40,3357,3357,0,0,3357,3326,2927,265,3,121,1,9,31,29,2,0,0,0,3357,36,3321,3357,1503,1854,2927,42,201301
42,91,201302,1052198,3069,1254,1254,0,1254,1199,55,3069,3069,0,0,3069,3010,2425,508,13,38,3,23,59,58,1,0,0,0,3069,101,2968,3069,1477,1592,2425,42,201302
42,91,201404,8774125,4984,1811,1811,0,1811,1744,67,4984,4984,0,0,4984,4965,4343,129,1,490,0,2,19,18,1,0,0,0,4984,35,4949,4984,2460,2524,4343,42,201404
42,91,201406,5979079,4617,1590,1590,0,1590,1573,17,4617,4617,0,0,4617,4583,3988,358,10,215,0,12,34,32,0,2,0,0,4617,49,4568,4617,2292,2325,3988,42,201406
42,91,201407,2437758,2414,857,857,0,857,842,15,2414,2414,0,0,2414,2396,1750,583,5,44,1,13,18,17,1,0,0,0,2414,27,2387,2414,1171,1243,1750,42,201407
42,91,201408,6092114,4627,1485,1485,0,1485,1477,8,4627,4627,0,0,4627,4600,4027,93,1,475,0,4,27,23,4,0,0,0,4627,33,4594,4627,2237,2390,4027,42,201408
42,91,201409,6092249,4282,1504,1504,0,1504,1482,22,4282,4282,0,0,4282,4260,3957,70,4,228,0,1,22,22,0,0,0,0,4282,45,4237,4282,2123,2159,3957,42,201409
42,91,201410,2429247,2444,1034,1034,0,1034,1011,23,2444,2444,0,0,2444,2438,2260,68,0,101,0,9,6,6,0,0,0,0,2444,28,2416,2444,1159,1285,2260,42,201410
42,91,201411,2378725,2510,1063,1063,0,1063,1045,18,2510,2510,0,0,2510,2481,2312,101,2,58,0,8,29,25,4,0,0,0,2510,16,2494,2510,1177,1333,2312,42,201411
42,91,201501,4539577,3462,1528,1528,0,1528,1446,82,3462,3462,0,0,3462,3434,3171,45,1,214,1,2,28,23,5,0,0,0,3462,48,3414,3462,1497,1965,3171,42,201501
42,91,201502,3742333,1843,719,719,0,719,705,14,1843,1843,0,0,1843,1831,1763,23,1,43,0,1,12,12,0,0,0,0,1843,19,1824,1843,872,971,1763,42,201502
42,91,201603,2401307,4663,1757,1757,0,1757,1703,54,4663,4663,0,0,4663,4541,2520,1892,10,88,2,29,122,100,22,0,0,0,4663,102,4561,4663,2136,2527,2520,42,201603
42,91,201604,1036636,3339,1184,1184,0,1184,1162,22,3339,3339,0,0,3339,3298,2278,914,4,73,2,27,41,41,0,0,0,0,3339,66,3273,3339,1644,1695,2278,42,201604
42,91,201605,1193035,3086,1086,1086,0,1086,1072,14,3086,3086,0,0,3086,3036,2619,316,3,66,0,32,50,47,3,0,0,0,3086,64,3022,3086,1464,1622,2619,42,201605
42,91,201606,897906,2589,980,980,0,980,950,30,2589,2589,0,0,2589,2544,1623,822,5,57,11,26,45,41,4,0,0,0,2589,49,2540,2589,1219,1370,1623,42,201606
42,91,201607,1594034,3600,1442,1442,0,1442,1417,25,3600,3600,0,0,3600,3549,3178,232,1,119,0,19,51,38,13,0,0,0,3600,66,3534,3600,1715,1885,3178,42,201607
42,91,201608,5004844,4580,1794,1794,0,1794,1759,35,4580,4580,0,0,4580,4534,4198,159,2,158,3,14,46,45,1,0,0,0,4580,67,4513,4580,2200,2380,4198,42,201608
42,91,201703,2179738,3127,1170,1170,0,1170,1150,20,3127,3127,0,0,3127,3107,2985,68,5,28,3,18,20,20,0,0,0,0,3127,39,3088,3127,1523,1604,2985,42,201703
42,91,201704,1374393,3434,1286,1286,0,1286,1259,27,3434,3434,0,0,3434,3404,2877,470,1,38,0,18,30,28,2,0,0,0,3434,45,3389,3434,1666,1768,2877,42,201704
42,91,201705,1872188,4538,1724,1724,0,1724,1689,35,4538,4538,0,0,4538,4491,4209,132,4,130,2,14,47,43,4,0,0,0,4538,69,4469,4538,2203,2335,4209,42,201705
42,91,201706,2524102,4361,1793,1793,0,1793,1722,71,4361,4361,0,0,4361,4313,3716,338,6,218,4,31,48,40,3,5,0,0,4361,75,4286,4361,2126,2235,3716,42,201706
42,91,201800,2398480,3127,1473,1473,0,1473,1412,61,3127,3127,0,0,3127,3102,2938,71,4,82,0,7,25,20,4,1,0,0,3127,26,3101,3127,1304,1823,2938,42,201800
42,91,201901,5049943,4546,1830,1830,0,1830,1801,29,4546,4546,0,0,4546,4528,4326,26,2,158,0,16,18,16,2,0,0,0,4546,60,4486,4546,2204,2342,4326,42,201901
42,91,201902,4216854,5808,2601,2601,0,2601,2443,158,5808,5808,0,0,5808,5753,4793,564,2,360,0,34,55,54,1,0,0,0,5808,88,5720,5808,2714,3094,4793,42,201902
42,91,202000,898443,2577,1091,1091,0,1091,1060,31,2577,2577,0,0,2577,2560,2525,1,1,25,0,8,17,17,0,0,0,0,2577,15,2562,2577,1234,1343,2525,42,202000
42,91,202100,1478587,4478,2085,2085,0,2085,2035,50,4478,4478,0,0,4478,4438,4192,179,2,42,1,22,40,36,3,1,0,0,4478,58,4420,4478,1975,2503,4192,42,202100
42,91,202201,3227902,4953,1794,1794,0,1794,1760,34,4953,4953,0,0,4953,4900,4234,315,3,318,1,29,53,49,4,0,0,0,4953,90,4863,4953,2334,2619,4234,42,202201
42,91,202202,2084114,2953,998,998,0,998,983,15,2953,2953,0,0,2953,2875,1561,810,7,435,1,61,78,72,3,0,3,0,2953,118,2835,2953,1448,1505,1561,42,202202
42,91,202301,2747421,4865,2186,2186,0,2186,2038,148,4865,4865,0,0,4865,4815,4254,250,3,262,2,44,50,40,7,3,0,0,4865,89,4776,4865,2315,2550,4254,42,202301
42,91,202302,1736854,2317,1005,1005,0,1005,959,46,2317,2317,0,0,2317,2272,1734,458,2,72,0,6,45,43,2,0,0,0,2317,46,2271,2317,1062,1255,1734,42,202302
42,91,202401,729586,3472,1736,1736,0,1736,1675,61,3472,3472,0,0,3472,3368,200,2768,8,341,0,51,104,89,11,4,0,0,3472,83,3389,3472,1614,1858,200,42,202401
42,91,202402,2712465,5105,1856,1856,0,1856,1794,62,5105,5105,0,0,5105,5007,2743,1602,9,591,1,61,98,85,10,3,0,0,5105,131,4974,5105,2438,2667,2743,42,202402
42,91,202500,5331589,5012,2088,2088,0,2088,1967,121,5012,5012,0,0,5012,4943,2758,2005,8,145,15,12,69,61,7,1,0,0,5012,66,4946,5012,2097,2915,2758,42,202500
42,91,202602,1620337,2675,937,937,0,937,926,11,2675,2675,0,0,2675,2661,2402,215,2,34,3,5,14,13,1,0,0,0,2675,19,2656,2675,1141,1534,2402,42,202602
42,91,202603,1507707,3187,1369,1369,0,1369,1332,37,3187,3187,0,0,3187,3157,2735,306,4,103,0,9,30,26,4,0,0,0,3187,46,3141,3187,1485,1702,2735,42,202603
42,91,202604,1692677,2336,928,928,0,928,912,16,2336,2336,0,0,2336,2314,1882,345,0,75,0,12,22,20,1,1,0,0,2336,44,2292,2336,1144,1192,1882,42,202604
42,91,203000,17124475,2630,993,993,0,993,933,60,2630,2630,0,0,2630,2594,2393,72,0,124,0,5,36,28,8,0,0,0,2630,41,2589,2630,1308,1322,2393,42,203000
42,91,203103,6990314,2951,1045,1045,0,1045,1017,28,2951,2951,0,0,2951,2948,2814,27,0,104,0,3,3,3,0,0,0,0,2951,24,2927,2951,1469,1482,2814,42,203103
42,91,203104,4245495,4015,1437,1437,0,1437,1416,21,4015,4015,0,0,4015,3991,3843,68,2,75,0,3,24,24,0,0,0,0,4015,27,3988,4015,1879,2136,3843,42,203104
42,91,203105,7681511,5456,2134,2134,0,2134,2086,48,5456,5456,0,0,5456,5435,5061,149,1,212,0,12,21,21,0,0,0,0,5456,57,5399,5456,2603,2853,5061,42,203105
42,91,203106,1786883,1650,763,763,0,763,727,36,1650,1650,0,0,1650,1628,1471,53,1,103,0,0,22,22,0,0,0,0,1650,16,1634,1650,819,831,1471,42,203106
42,91,203203,5171778,4205,1657,1657,0,1657,1509,148,4205,4205,0,0,4205,4164,3554,210,2,380,0,18,41,36,5,0,0,0,4205,73,4132,4205,2072,2133,3554,42,203203
42,91,203204,8296250,5728,2345,2345,0,2345,2241,104,5728,5728,0,0,5728,5680,4902,187,8,577,0,6,48,44,4,0,0,0,5728,89,5639,5728,2704,3024,4902,42,203204
42,91,203205,5952050,2319,828,828,0,828,807,21,2319,2319,0,0,2319,2282,1844,337,0,94,0,7,37,29,8,0,0,0,2319,20,2299,2319,1123,1196,1844,42,203205
42,91,203207,8340162,3283,1100,1100,0,1100,1082,18,3283,3283,0,0,3283,3263,2977,70,2,206,0,8,20,20,0,0,0,0,3283,34,3249,3283,1619,1664,2977,42,203207
42,91,203208,5710362,3027,1375,1375,0,1375,1321,54,3027,3027,0,0,3027,3008,2744,66,0,195,0,3,19,19,0,0,0,0,3027,31,2996,3027,1429,1598,2744,42,203208
42,91,203302,7650418,6435,2295,2295,0,2295,2249,46,6435,6435,0,0,6435,6400,5865,337,5,172,0,21,35,34,1,0,0,0,6435,65,6370,6435,3116,3319,5865,42,203302
42,91,203303,3939632,3536,1397,1397,0,1397,1361,36,3536,3536,0,0,3536,3495,3064,301,9,98,0,23,41,41,0,0,0,0,3536,49,3487,3536,1643,1893,3064,42,203303
42,91,203304,2299977,3238,1613,1613,0,1613,1545,68,3238,3238,0,0,3238,3208,2801,162,3,235,0,7,30,28,2,0,0,0,3238,40,3198,3238,1528,1710,2801,42,203304
42,91,203401,3523701,6356,2944,2944,0,2944,2840,104,6356,6356,0,0,6356,6264,5560,526,9,132,2,35,92,85,6,1,0,0,6356,124,6232,6356,3001,3355,5560,42,203401
42,91,203402,6701969,5520,2380,2380,0,2380,2325,55,5520,5520,0,0,5520,5480,4947,269,2,228,6,28,40,39,1,0,0,0,5520,80,5440,5520,2689,2831,4947,42,203402
42,91,203403,3648657,3025,1565,1565,0,1565,1449,116,3025,3025,0,0,3025,2998,2828,114,0,47,0,9,27,26,1,0,0,0,3025,32,2993,3025,1448,1577,2828,42,203403
42,91,203500,1748460,5971,2642,2642,0,2642,2484,158,5971,5971,0,0,5971,5843,3427,2006,12,249,0,149,128,117,11,0,0,0,5971,365,5606,5971,2830,3141,3427,42,203500
42,91,203601,444904,2767,1200,1200,0,1200,1018,182,2767,2767,0,0,2767,2677,735,1736,4,44,2,156,90,80,10,0,0,0,2767,323,2444,2767,1347,1420,735,42,203601
42,91,203602,1103479,3792,1497,1497,0,1497,1413,84,3792,3792,0,0,3792,3667,2537,984,3,62,1,80,125,119,5,1,0,0,3792,169,3623,3792,1702,2090,2537,42,203602
42,91,203700,4850533,1532,513,513,0,513,445,68,1532,1532,0,0,1532,1507,1098,372,2,20,0,15,25,23,2,0,0,0,1532,67,1465,1532,860,672,1098,42,203700
42,91,203801,836338,3409,1409,1409,0,1409,1310,99,3409,3409,0,0,3409,3272,2523,551,2,103,0,93,137,123,14,0,0,0,3409,301,3108,3409,1660,1749,2523,42,203801
42,91,203803,771820,4977,2344,2344,0,2344,2020,324,4977,4977,0,0,4977,4813,2987,1309,7,196,2,312,164,152,12,0,0,0,4977,614,4363,4977,2490,2487,2987,42,203803
42,91,203804,619356,2950,1188,1188,0,1188,1046,142,2950,2950,0,0,2950,2862,1734,935,15,58,4,116,88,86,2,0,0,0,2950,316,2634,2950,1479,1471,1734,42,203804
42,91,203901,440370,3101,1318,1318,0,1318,1056,262,3101,3101,0,0,3101,2993,731,1861,14,41,0,346,108,101,7,0,0,0,3101,712,2389,3101,1514,1587,731,42,203901
42,91,203902,1471703,2785,1426,1426,0,1426,1237,189,2785,2785,0,0,2785,2689,1220,1133,4,155,1,176,96,90,6,0,0,0,2785,415,2370,2785,1349,1436,1220,42,203902
42,91,204002,7471215,3042,1363,1363,0,1363,1313,50,3042,3042,0,0,3042,2988,2649,187,3,127,2,20,54,51,3,0,0,0,3042,66,2976,3042,1493,1549,2649,42,204002
42,91,204004,2009889,2868,1266,1266,0,1266,1206,60,2868,2868,0,0,2868,2856,2650,102,6,94,0,4,12,12,0,0,0,0,2868,31,2837,2868,1336,1532,2650,42,204004
42,91,204005,1043163,966,361,361,0,361,353,8,966,966,0,0,966,963,861,39,1,60,0,2,3,3,0,0,0,0,966,8,958,966,471,495,861,42,204005
42,91,204007,1608977,2261,970,970,0,970,960,10,2261,2261,0,0,2261,2236,1860,125,2,242,0,7,25,25,0,0,0,0,2261,34,2227,2261,1127,1134,1860,42,204007
42,91,204008,3018873,2859,1145,1145,0,1145,1127,18,2859,2859,0,0,2859,2831,2590,101,0,131,0,9,28,21,7,0,0,0,2859,34,2825,2859,1403,1456,2590,42,204008
42,91,204009,3968028,1438,658,658,0,658,624,34,1438,1438,0,0,1438,1429,1270,67,1,86,0,5,9,9,0,0,0,0,1438,8,1430,1438,679,759,1270,42,204009
42,91,204010,2667650,2611,940,940,0,940,929,11,2611,2611,0,0,2611,2599,2441,48,1,97,0,12,12,11,0,1,0,0,2611,20,2591,2611,1297,1314,2441,42,204010
42,91,204101,1279699,4715,2103,2103,0,2103,2009,94,4715,4715,0,0,4715,4692,4542,92,1,43,0,14,23,21,2,0,0,0,4715,57,4658,4715,2320,2395,4542,42,204101
42,91,204102,1266213,2874,1415,1415,0,1415,1320,95,2874,2874,0,0,2874,2827,2279,498,5,21,1,23,47,47,0,0,0,0,2874,45,2829,2874,1362,1512,2279,42,204102
42,91,204200,2201240,1446,633,633,0,633,600,33,1446,1446,0,0,1446,1430,1358,41,1,26,1,3,16,16,0,0,0,0,1446,15,1431,1446,730,716,1358,42,204200
42,91,204300,2055446,2454,1263,1263,0,1263,1180,83,2454,2454,0,0,2454,2435,2239,98,9,81,1,7,19,19,0,0,0,0,2454,46,2408,2454,1153,1301,2239,42,204300
42,91,204400,2428161,3237,1244,1244,0,1244,1206,38,3237,3237,0,0,3237,3212,3021,42,2,138,0,9,25,25,0,0,0,0,3237,34,3203,3237,1537,1700,3021,42,204400
42,91,204500,2752567,4880,1718,1718,0,1718,1665,53,4880,4880,0,0,4880,4821,4541,122,0,128,5,25,59,55,3,1,0,0,4880,68,4812,4880,2352,2528,4541,42,204500
42,91,204600,4819574,4756,1618,1618,0,1618,1591,27,4756,4756,0,0,4756,4721,4510,51,3,137,0,20,35,35,0,0,0,0,4756,61,4695,4756,2208,2548,4510,42,204600
42,91,204701,3162271,2260,1146,1146,0,1146,1111,35,2260,2260,0,0,2260,2246,2103,42,1,98,1,1,14,14,0,0,0,0,2260,20,2240,2260,1043,1217,2103,42,204701
42,91,204702,2724704,3350,1320,1320,0,1320,1282,38,3350,3350,0,0,3350,3312,3115,56,2,126,0,13,38,31,7,0,0,0,3350,46,3304,3350,1647,1703,3115,42,204702
42,91,204800,15780528,5399,2036,2036,0,2036,1952,84,5399,5399,0,0,5399,5358,5181,42,2,123,3,7,41,41,0,0,0,0,5399,51,5348,5399,2529,2870,5181,42,204800
42,91,204900,10281165,5047,1785,1785,0,1785,1721,64,5047,5047,0,0,5047,5015,4773,121,2,106,0,13,32,30,2,0,0,0,5047,60,4987,5047,2230,2817,4773,42,204900
42,91,205000,1274788,1764,834,834,0,834,780,54,1764,1764,0,0,1764,1737,1430,235,3,63,0,6,27,25,2,0,0,0,1764,39,1725,1764,802,962,1430,42,205000
42,91,205100,1890726,3190,841,841,0,841,804,37,3190,3190,0,0,3190,3108,2560,232,2,261,14,39,82,79,3,0,0,0,3190,95,3095,3190,864,2326,2560,42,205100
42,91,205200,3260467,2933,1347,1347,0,1347,1291,56,2933,2933,0,0,2933,2908,2814,23,0,61,0,10,25,25,0,0,0,0,2933,32,2901,2933,1347,1586,2814,42,205200
42,91,205300,669475,2856,871,871,0,871,832,39,2856,2856,0,0,2856,2815,1931,674,8,150,1,51,41,39,2,0,0,0,2856,98,2758,2856,1346,1510,1931,42,205300
42,91,205400,4793358,6057,2767,2767,0,2767,2662,105,6057,6057,0,0,6057,5982,5630,102,7,209,4,30,75,68,3,4,0,0,6057,111,5946,6057,2846,3211,5630,42,205400
42,91,205501,978425,3732,1801,1801,0,1801,1744,57,3732,3732,0,0,3732,3647,2850,636,4,106,11,40,85,79,6,0,0,0,3732,99,3633,3732,1672,2060,2850,42,205501
42,91,205502,2130356,3340,1294,1294,0,1294,1267,27,3340,3340,0,0,3340,3303,3157,35,0,99,1,11,37,27,6,4,0,0,3340,50,3290,3340,1576,1764,3157,42,205502
42,91,205503,2361391,4595,1814,1814,0,1814,1780,34,4595,4595,0,0,4595,4557,4192,183,0,162,0,20,38,37,1,0,0,0,4595,46,4549,4595,2080,2515,4192,42,205503
42,91,205600,1279030,4233,1981,1981,0,1981,1904,77,4233,4233,0,0,4233,4188,4031,50,5,96,0,6,45,38,7,0,0,0,4233,59,4174,4233,1946,2287,4031,42,205600
42,91,205700,1694774,4371,2088,2088,0,2088,1983,105,4371,4371,0,0,4371,4281,3997,117,6,106,0,55,90,85,4,1,0,0,4371,168,4203,4371,2166,2205,3997,42,205700
42,91,205801,12480338,2617,1743,1743,0,1743,1600,143,2617,2617,0,0,2617,2581,2062,105,0,376,2,36,36,35,1,0,0,0,2617,61,2556,2617,1295,1322,2062,42,205801
42,91,205805,2640727,3132,1291,1291,0,1291,1267,24,3132,3132,0,0,3132,3069,2658,97,0,283,0,31,63,48,15,0,0,0,3132,54,3078,3132,1522,1610,2658,42,205805
42,91,205806,1909391,1780,735,735,0,735,702,33,1780,1780,0,0,1780,1759,1627,55,1,73,0,3,21,21,0,0,0,0,1780,33,1747,1780,852,928,1627,42,205806
42,91,205807,1630407,2013,1225,1225,0,1225,1074,151,2013,2013,0,0,2013,1981,1546,98,3,308,0,26,32,31,0,1,0,0,2013,48,1965,2013,1037,976,1546,42,205807
42,91,205808,4849249,4671,1639,1639,0,1639,1618,21,4671,4671,0,0,4671,4620,4019,173,0,410,0,18,51,51,0,0,0,0,4671,93,4578,4671,2247,2424,4019,42,205808
42,91,205809,2283665,2791,992,992,0,992,983,9,2791,2791,0,0,2791,2755,2450,108,8,171,2,16,36,34,2,0,0,0,2791,36,2755,2791,1357,1434,2450,42,205809
42,91,205903,4245903,2470,946,946,0,946,924,22,2470,2470,0,0,2470,2439,2225,103,1,105,2,3,31,30,1,0,0,0,2470,31,2439,2470,1198,1272,2225,42,205903
42,91,205904,3734849,2231,958,958,0,958,935,23,2231,2231,0,0,2231,2211,1985,159,1,61,0,5,20,20,0,0,0,0,2231,29,2202,2231,1092,1139,1985,42,205904
42,91,205905,3162361,3220,1787,1787,0,1787,1679,108,3220,3220,0,0,3220,3180,2515,203,17,414,3,28,40,38,2,0,0,0,3220,62,3158,3220,1652,1568,2515,42,205905
42,91,205906,6731524,1938,835,835,0,835,793,42,1938,1938,0,0,1938,1914,1680,144,3,70,5,12,24,24,0,0,0,0,1938,34,1904,1938,976,962,1680,42,205906
42,91,206004,5828957,5867,1623,1623,0,1623,1566,57,5867,5867,0,0,5867,5819,4204,1224,7,250,14,120,48,48,0,0,0,0,5867,213,5654,5867,3496,2371,4204,42,206004
42,91,206005,4465963,4652,1620,1620,0,1620,1581,39,4652,4652,0,0,4652,4620,4311,57,8,238,0,6,32,30,2,0,0,0,4652,60,4592,4652,2331,2321,4311,42,206005
42,91,206006,4650797,1924,720,720,0,720,706,14,1924,1924,0,0,1924,1917,1834,28,2,48,0,5,7,7,0,0,0,0,1924,13,1911,1924,950,974,1834,42,206006
42,91,206007,10887112,5311,2082,2082,0,2082,2002,80,5311,5311,0,0,5311,5288,4575,262,3,361,1,86,23,23,0,0,0,0,5311,128,5183,5311,2775,2536,4575,42,206007
42,91,206008,8644844,4182,1463,1463,0,1463,1421,42,4182,4182,0,0,4182,4158,3950,51,4,138,0,15,24,22,1,0,1,0,4182,50,4132,4182,2065,2117,3950,42,206008
42,91,206009,5274620,454,182,182,0,182,170,12,454,454,0,0,454,452,440,2,0,10,0,0,2,2,0,0,0,0,454,6,448,454,218,236,440,42,206009
42,91,206102,17558680,5105,2065,2065,0,2065,1981,84,5105,5105,0,0,5105,5076,4721,138,6,194,2,15,29,28,1,0,0,0,5105,85,5020,5105,2471,2634,4721,42,206102
42,91,206104,9179204,2383,839,839,0,839,821,18,2383,2383,0,0,2383,2356,2208,73,0,58,0,17,27,26,1,0,0,0,2383,36,2347,2383,1175,1208,2208,42,206104
42,91,206105,13941534,3564,992,992,0,992,965,27,3564,3564,0,0,3564,3537,3349,90,1,92,2,3,27,27,0,0,0,0,3564,47,3517,3564,1636,1928,3349,42,206105
42,91,206106,5537560,4346,1649,1649,0,1649,1588,61,4346,4346,0,0,4346,4312,4121,94,8,83,0,6,34,30,4,0,0,0,4346,39,4307,4346,2045,2301,4121,42,206106
42,91,206201,1254647,2584,1311,1311,0,1311,1243,68,2584,2584,0,0,2584,2569,2514,29,3,15,0,8,15,13,2,0,0,0,2584,20,2564,2584,1230,1354,2514,42,206201
42,91,206202,781563,1662,728,728,0,728,685,43,1662,1662,0,0,1662,1638,1561,54,7,12,0,4,24,20,4,0,0,0,1662,30,1632,1662,818,844,1561,42,206202
42,91,206300,4038863,8032,1438,1438,0,1438,1408,30,8032,8032,0,0,8032,7967,4966,2505,8,171,1,316,65,63,2,0,0,0,8032,412,7620,8032,5671,2361,4966,42,206300
42,91,206400,5373914,3210,1351,1351,0,1351,1292,59,3210,3210,0,0,3210,3157,3018,77,7,44,0,11,53,53,0,0,0,0,3210,38,3172,3210,1599,1611,3018,42,206400
42,91,206500,12518340,7093,2556,2556,0,2556,2468,88,7093,7093,0,0,7093,7011,6596,223,8,135,5,44,82,76,6,0,0,0,7093,108,6985,7093,3517,3576,6596,42,206500
42,91,206600,1044390,1693,662,662,0,662,626,36,1693,1693,0,0,1693,1673,1595,48,0,19,1,10,20,19,1,0,0,0,1693,36,1657,1693,794,899,1595,42,206600
42,91,206701,29184201,6410,2474,2474,0,2474,2350,124,6410,6410,0,0,6410,6377,6220,61,18,59,0,19,33,27,6,0,0,0,6410,69,6341,6410,3109,3301,6220,42,206701
42,91,206702,6648159,106,3,3,0,3,3,0,106,106,0,0,106,106,19,80,0,0,0,7,0,0,0,0,0,0,106,9,97,106,103,3,19,42,206702
42,91,206801,30562756,5345,1978,1978,0,1978,1905,73,5345,5345,0,0,5345,5297,4888,127,2,268,0,12,48,47,1,0,0,0,5345,48,5297,5345,2592,2753,4888,42,206801
42,91,206802,11447866,2444,1048,1048,0,1048,991,57,2444,2444,0,0,2444,2427,2289,54,0,77,0,7,17,15,2,0,0,0,2444,20,2424,2444,1189,1255,2289,42,206802
42,91,206901,4090475,4379,1739,1739,0,1739,1694,45,4379,4379,0,0,4379,4291,3580,179,4,489,3,36,88,82,6,0,0,0,4379,98,4281,4379,2107,2272,3580,42,206901
42,91,206904,7930883,5325,2338,2338,0,2338,2255,83,5325,5325,0,0,5325,5248,4749,214,6,242,0,37,77,74,3,0,0,0,5325,93,5232,5325,2403,2922,4749,42,206904
42,91,206905,8373049,4777,1702,1702,0,1702,1684,18,4777,4777,0,0,4777,4717,4282,165,4,258,1,7,60,58,2,0,0,0,4777,64,4713,4777,2336,2441,4282,42,206905
42,91,206906,4707465,3116,1256,1256,0,1256,1239,17,3116,3116,0,0,3116,3100,2927,53,1,108,0,11,16,16,0,0,0,0,3116,36,3080,3116,1517,1599,2927,42,206906
42,91,207001,27412326,5946,2083,2083,0,2083,2029,54,5946,5946,0,0,5946,5878,5516,199,3,143,0,17,68,63,4,1,0,0,5946,53,5893,5946,2910,3036,5516,42,207001
42,91,207003,5612508,2564,893,893,0,893,869,24,2564,2564,0,0,2564,2552,2425,51,2,68,0,6,12,12,0,0,0,0,2564,33,2531,2564,1297,1267,2425,42,207003
42,91,207004,4326152,4383,1555,1555,0,1555,1534,21,4383,4383,0,0,4383,4348,4103,129,2,91,6,17,35,35,0,0,0,0,4383,97,4286,4383,2119,2264,4103,42,207004
42,91,207101,23703487,5011,1780,1780,0,1780,1748,32,5011,5011,0,0,5011,4986,4910,30,4,35,0,7,25,25,0,0,0,0,5011,41,4970,5011,2429,2582,4910,42,207101
42,91,207103,7071341,3782,1278,1278,0,1278,1264,14,3782,3782,0,0,3782,3757,3561,50,2,119,0,25,25,25,0,0,0,0,3782,45,3737,3782,1852,1930,3561,42,207103
42,91,207104,5050037,2730,1178,1178,0,1178,1139,39,2730,2730,0,0,2730,2726,2657,19,3,43,1,3,4,4,0,0,0,0,2730,17,2713,2730,1196,1534,2657,42,207104
42,91,207201,939771,2527,1004,1004,0,1004,963,41,2527,2527,0,0,2527,2505,2374,34,2,76,2,17,22,21,1,0,0,0,2527,81,2446,2527,1254,1273,2374,42,207201
42,91,207202,1957735,4203,1716,1716,0,1716,1672,44,4203,4203,0,0,4203,4141,3797,33,11,192,0,108,62,59,3,0,0,0,4203,208,3995,4203,2069,2134,3797,42,207202
42,91,207300,1251738,2469,962,962,0,962,942,20,2469,2469,0,0,2469,2421,2236,27,0,124,1,33,48,42,6,0,0,0,2469,97,2372,2469,1236,1233,2236,42,207300
42,91,207400,24697496,2363,821,821,0,821,807,14,2363,2363,0,0,2363,2340,2300,16,2,18,0,4,23,23,0,0,0,0,2363,26,2337,2363,1189,1174,2300,42,207400
42,91,207500,23326287,3024,1074,1074,0,1074,1053,21,3024,3024,0,0,3024,3002,2935,15,8,26,1,17,22,21,1,0,0,0,3024,25,2999,3024,1500,1524,2935,42,207500
42,91,207600,33304817,3688,1457,1457,0,1457,1405,52,3688,3688,0,0,3688,3655,3597,28,5,5,0,20,33,30,3,0,0,0,3688,40,3648,3688,1841,1847,3597,42,207600
42,91,207800,52369664,4885,1764,1764,0,1764,1737,27,4885,4885,0,0,4885,4862,4790,34,7,15,0,16,23,22,1,0,0,0,4885,39,4846,4885,2471,2414,4790,42,207800
42,91,207900,1867226,2196,944,944,0,944,899,45,2196,2196,0,0,2196,2166,2148,7,1,2,1,7,30,19,4,7,0,0,2196,34,2162,2196,1047,1149,2148,42,207900
42,91,208000,1983261,2732,1078,1078,0,1078,1009,69,2732,2732,0,0,2732,2712,2660,22,2,13,0,15,20,17,3,0,0,0,2732,44,2688,2732,1297,1435,2660,42,208000
42,91,208100,1344185,3103,1173,1173,0,1173,1124,49,3103,3103,0,0,3103,3079,3003,28,4,16,0,28,24,23,1,0,0,0,3103,82,3021,3103,1511,1592,3003,42,208100
42,91,208201,24908576,2373,815,815,0,815,803,12,2373,2373,0,0,2373,2365,2347,7,0,4,1,6,8,7,1,0,0,0,2373,11,2362,2373,1212,1161,2347,42,208201
42,91,208203,7830149,3748,1508,1508,0,1508,1461,47,3748,3748,0,0,3748,3720,3632,33,6,43,1,5,28,27,1,0,0,0,3748,16,3732,3748,1818,1930,3632,42,208203
42,91,208204,6998228,2983,969,969,0,969,947,22,2983,2983,0,0,2983,2973,2922,30,1,18,0,2,10,10,0,0,0,0,2983,16,2967,2983,1472,1511,2922,42,208204
42,91,208301,33270559,2387,917,917,0,917,873,44,2387,2387,0,0,2387,2376,2355,4,1,13,0,3,11,10,1,0,0,0,2387,18,2369,2387,1203,1184,2355,42,208301
42,91,208302,22651310,4982,1698,1698,0,1698,1659,39,4982,4982,0,0,4982,4960,4890,19,4,45,1,1,22,18,4,0,0,0,4982,38,4944,4982,2485,2497,4890,42,208302
42,91,208400,25816778,3141,1088,1088,0,1088,1045,43,3141,3141,0,0,3141,3112,3047,45,6,9,0,5,29,28,1,0,0,0,3141,16,3125,3141,1528,1613,3047,42,208400
42,91,208500,20711171,4795,1806,1806,0,1806,1730,76,4795,4795,0,0,4795,4742,4580,89,11,39,0,23,53,52,1,0,0,0,4795,71,4724,4795,2355,2440,4580,42,208500
42,91,208601,28794668,4081,1555,1555,0,1555,1479,76,4081,4081,0,0,4081,4053,3932,52,9,44,0,16,28,28,0,0,0,0,4081,39,4042,4081,2038,2043,3932,42,208601
42,91,208603,17190498,4942,1998,1998,0,1998,1873,125,4942,4942,0,0,4942,4893,4669,143,13,49,0,19,49,45,1,1,2,0,4942,65,4877,4942,2442,2500,4669,42,208603
42,91,208604,12475710,4511,1889,1889,0,1889,1791,98,4511,4511,0,0,4511,4471,4270,90,4,82,0,25,40,37,3,0,0,0,4511,75,4436,4511,2240,2271,4270,42,208604
42,91,208702,7098097,3266,1237,1237,0,1237,1203,34,3266,3266,0,0,3266,3247,3185,29,1,27,1,4,19,18,1,0,0,0,3266,20,3246,3266,1646,1620,3185,42,208702
42,91,208703,6836496,3717,1401,1401,0,1401,1366,35,3717,3717,0,0,3717,3689,3532,120,4,29,0,4,28,26,2,0,0,0,3717,47,3670,3717,1831,1886,3532,42,208703
42,91,208704,6513694,4230,1489,1489,0,1489,1446,43,4230,4230,0,0,4230,4135,3287,772,7,45,3,21,95,88,7,0,0,0,4230,70,4160,4230,1956,2274,3287,42,208704
42,91,208801,617315,1130,575,575,0,575,536,39,1130,1130,0,0,1130,1105,984,90,3,6,0,22,25,25,0,0,0,0,1130,59,1071,1130,544,586,984,42,208801
42,91,208802,2078484,2989,1389,1389,0,1389,1289,100,2989,2989,0,0,2989,2952,2747,140,7,23,1,34,37,37,0,0,0,0,2989,66,2923,2989,1451,1538,2747,42,208802
42,91,208901,1740900,3448,1554,1554,0,1554,1466,88,3448,3448,0,0,3448,3370,3050,234,8,18,6,54,78,77,1,0,0,0,3448,79,3369,3448,1653,1795,3050,42,208901
42,91,208903,2139257,2872,1268,1268,0,1268,1140,128,2872,2872,0,0,2872,2772,1837,839,11,17,1,67,100,89,11,0,0,0,2872,203,2669,2872,1344,1528,1837,42,208903
42,91,208904,509080,3020,1608,1608,0,1608,1350,258,3020,3020,0,0,3020,2888,1984,724,7,34,3,136,132,126,6,0,0,0,3020,278,2742,3020,1491,1529,1984,42,208904
42,91,208905,1181922,2800,1280,1280,0,1280,1240,40,2800,2800,0,0,2800,2762,2666,66,0,13,6,11,38,36,2,0,0,0,2800,39,2761,2800,1317,1483,2666,42,208905
42,91,208906,1215636,4015,1629,1629,0,1629,1491,138,4015,4015,0,0,4015,3887,3013,778,6,16,2,72,128,121,5,2,0,0,4015,208,3807,4015,1898,2117,3013,42,208906
42,91,209000,3025390,1585,670,670,0,670,634,36,1585,1585,0,0,1585,1522,1062,420,8,15,0,17,63,59,4,0,0,0,1585,58,1527,1585,688,897,1062,42,209000
42,91,209100,13075993,4102,1459,1459,0,1459,1417,42,4102,4102,0,0,4102,4066,3905,103,10,37,0,11,36,34,2,0,0,0,4102,42,4060,4102,2046,2056,3905,42,209100
42,91,209201,5096312,1597,652,652,0,652,621,31,1597,1597,0,0,1597,1572,1440,109,1,13,0,9,25,25,0,0,0,0,1597,30,1567,1597,777,820,1440,42,209201
42,91,209202,995363,2218,954,954,0,954,903,51,2218,2218,0,0,2218,2180,1966,166,6,19,1,22,38,38,0,0,0,0,2218,53,2165,2218,1060,1158,1966,42,209202
42,91,210100,2736320,3839,1537,1537,0,1537,1502,35,3839,3839,0,0,3839,3808,3635,84,8,71,0,10,31,29,2,0,0,0,3839,49,3790,3839,1841,1998,3635,42,210100
42,91,210200,2584251,2756,1064,1064,0,1064,1056,8,2756,2756,0,0,2756,2745,2483,190,4,59,0,9,11,10,0,1,0,0,2756,28,2728,2756,1346,1410,2483,42,210200
42,91,210300,4985280,3807,1528,1528,0,1528,1478,50,3807,3807,0,0,3807,3788,3538,172,1,59,1,17,19,16,1,0,0,2,3807,37,3770,3807,1779,2028,3538,42,210300
42,91,210400,3885813,4827,1805,1805,0,1805,1779,26,4827,4827,0,0,4827,4786,4077,594,1,101,0,13,41,37,4,0,0,0,4827,48,4779,4827,2044,2783,4077,42,210400
42,91,210500,3402563,4304,1697,1697,0,1697,1656,41,4304,4304,0,0,4304,4258,3561,583,11,86,0,17,46,43,3,0,0,0,4304,41,4263,4304,1962,2342,3561,42,210500
42,93,950100,143782880,3808,1446,1446,0,1446,1351,95,3808,3808,0,0,3808,3785,3739,31,2,7,0,6,23,23,0,0,0,0,3808,10,3798,3808,1904,1904,3739,42,950100
42,93,950200,21342696,4263,1542,1542,0,1542,1466,76,4263,4263,0,0,4263,4231,4006,82,1,116,0,26,32,26,5,1,0,0,4263,73,4190,4263,1871,2392,4006,42,950200
42,93,950300,4108354,4897,2523,2523,0,2523,2277,246,4897,4897,0,0,4897,4859,4704,38,6,88,0,23,38,35,3,0,0,0,4897,56,4841,4897,2235,2662,4704,42,950300
42,93,950400,169409371,5268,2116,2116,0,2116,1991,125,5268,5268,0,0,5268,5253,5179,34,3,23,0,14,15,14,1,0,0,0,5268,28,5240,5268,2651,2617,5179,42,950400
42,95,10100,1710353,3659,1572,1572,0,1572,1515,57,3659,3659,0,0,3659,3600,3195,153,11,129,0,112,59,58,1,0,0,0,3659,301,3358,3659,1755,1904,3195,42,10100
42,95,10200,7321205,3929,1485,1485,0,1485,1445,40,3929,3929,0,0,3929,3878,3693,29,1,139,1,15,51,49,2,0,0,0,3929,44,3885,3929,1809,2120,3693,42,10200
42,95,10300,1799074,3297,1532,1532,0,1532,1460,72,3297,3297,0,0,3297,3253,3109,48,3,34,0,59,44,42,0,0,2,0,3297,137,3160,3297,1561,1736,3109,42,10300
42,95,10400,2617604,4894,2161,2161,0,2161,2105,56,4894,4894,0,0,4894,4839,4499,168,5,98,2,67,55,54,1,0,0,0,4894,237,4657,4894,2311,2583,4499,42,10400
42,95,10500,1985843,4428,1778,1778,0,1778,1725,53,4428,4428,0,0,4428,4188,2092,378,21,29,0,1668,240,231,8,1,0,0,4428,2631,1797,4428,1956,2472,2092,42,10500
42,95,10600,2760485,6672,3069,3069,0,3069,2940,129,6672,6672,0,0,6672,6538,6056,104,9,76,2,291,134,129,5,0,0,0,6672,636,6036,6672,3165,3507,6056,42,10600
42,95,10700,1124064,4824,1814,1814,0,1814,1700,114,4824,4824,0,0,4824,4715,4222,130,15,85,0,263,109,102,7,0,0,0,4824,445,4379,4824,2229,2595,4222,42,10700
42,95,10800,777691,2632,1577,1577,0,1577,1493,84,2632,2632,0,0,2632,2578,2351,82,7,39,0,99,54,54,0,0,0,0,2632,215,2417,2632,1112,1520,2351,42,10800
42,95,10900,564880,3334,1396,1396,0,1396,1263,133,3334,3334,0,0,3334,3172,2169,301,16,23,1,662,162,160,2,0,0,0,3334,1263,2071,3334,1583,1751,2169,42,10900
42,95,11000,672466,5633,1326,1326,0,1326,1183,143,5633,5633,0,0,5633,5473,4458,225,18,322,1,449,160,149,9,2,0,0,5633,901,4732,5633,3233,2400,4458,42,11000
42,95,11100,946392,427,84,84,0,84,79,5,427,427,0,0,427,420,340,23,1,46,1,9,7,6,1,0,0,0,427,31,396,427,242,185,340,42,11100
42,95,11200,1238587,5395,2118,2118,0,2118,1926,192,5395,5395,0,0,5395,5104,3163,342,38,113,14,1434,291,281,9,1,0,0,5395,2766,2629,5395,2702,2693,3163,42,11200
42,95,11300,14994470,3176,1177,1177,0,1177,1094,83,3176,3176,0,0,3176,3026,1768,136,16,132,0,974,150,141,9,0,0,0,3176,1711,1465,3176,1569,1607,1768,42,11300
42,95,14100,3136540,5348,1614,1614,0,1614,1529,85,5348,5348,0,0,5348,5246,4967,147,5,90,6,31,102,92,7,2,1,0,5348,137,5211,5348,2637,2711,4967,42,14100
42,95,14200,1303031,5714,2407,2407,0,2407,2199,208,5714,5714,0,0,5714,5500,4546,577,9,118,0,250,214,204,8,2,0,0,5714,544,5170,5714,2695,3019,4546,42,14200
42,95,14300,1114725,4324,1610,1610,0,1610,1389,221,4324,4324,0,0,4324,4153,3149,727,15,60,12,190,171,163,8,0,0,0,4324,751,3573,4324,2378,1946,3149,42,14300
42,95,14400,894930,2420,1464,1464,0,1464,1231,233,2420,2420,0,0,2420,2368,1935,276,10,46,5,96,52,51,1,0,0,0,2420,271,2149,2420,1171,1249,1935,42,14400
42,95,14500,1479526,2950,1240,1240,0,1240,1140,100,2950,2950,0,0,2950,2847,1979,651,11,77,3,126,103,91,11,1,0,0,2950,351,2599,2950,1393,1557,1979,42,14500
42,95,14600,2200708,3053,1245,1245,0,1245,1148,97,3053,3053,0,0,3053,2945,2058,628,6,20,2,231,108,101,7,0,0,0,3053,410,2643,3053,1471,1582,2058,42,14600
42,95,14700,897916,2454,965,965,0,965,908,57,2454,2454,0,0,2454,2382,1976,332,7,26,0,41,72,70,2,0,0,0,2454,106,2348,2454,1211,1243,1976,42,14700
42,95,15100,113732158,6642,2821,2821,0,2821,2599,222,6642,6642,0,0,6642,6603,6504,42,8,35,0,14,39,36,3,0,0,0,6642,108,6534,6642,3330,3312,6504,42,15100
42,95,15201,5614296,6972,2919,2919,0,2919,2745,174,6972,6972,0,0,6972,6922,6839,29,10,23,0,21,50,49,1,0,0,0,6972,111,6861,6972,3316,3656,6839,42,15201
42,95,15202,1944376,979,417,417,0,417,387,30,979,979,0,0,979,974,969,2,1,0,0,2,5,5,0,0,0,0,979,5,974,979,484,495,969,42,15202
42,95,15300,46773006,4152,1670,1670,0,1670,1601,69,4152,4152,0,0,4152,4139,4117,2,3,4,0,13,13,13,0,0,0,0,4152,28,4124,4152,2001,2151,4117,42,15300
42,95,15400,62644912,3228,1347,1347,0,1347,1223,124,3228,3228,0,0,3228,3214,3173,22,2,8,1,8,14,14,0,0,0,0,3228,32,3196,3228,1659,1569,3173,42,15400
42,95,15500,64049031,5668,2191,2191,0,2191,2130,61,5668,5668,0,0,5668,5649,5603,21,1,16,0,8,19,19,0,0,0,0,5668,38,5630,5668,2790,2878,5603,42,15500
42,95,15600,3595716,3615,1506,1506,0,1506,1427,79,3615,3615,0,0,3615,3586,3536,17,4,20,0,9,29,28,1,0,0,0,3615,44,3571,3615,1723,1892,3536,42,15600
42,95,15700,3532377,2812,1294,1294,0,1294,1221,73,2812,2812,0,0,2812,2793,2745,13,1,19,0,15,19,18,0,1,0,0,2812,45,2767,2812,1321,1491,2745,42,15700
42,95,15800,65484138,6982,2406,2406,0,2406,2333,73,6982,6982,0,0,6982,6942,6861,13,17,27,0,24,40,40,0,0,0,0,6982,70,6912,6982,3508,3474,6861,42,15800
42,95,15901,47321568,5472,2207,2207,0,2207,2134,73,5472,5472,0,0,5472,5449,5409,21,2,8,3,6,23,23,0,0,0,0,5472,69,5403,5472,2739,2733,5409,42,15901
42,95,15902,50667580,3435,1348,1348,0,1348,1258,90,3435,3435,0,0,3435,3429,3392,11,2,10,1,13,6,6,0,0,0,0,3435,20,3415,3435,1790,1645,3392,42,15902
42,95,16001,42850724,5448,2006,2006,0,2006,1954,52,5448,5448,0,0,5448,5423,5370,22,15,9,0,7,25,25,0,0,0,0,5448,36,5412,5448,2762,2686,5370,42,16001
42,95,16002,34031048,4280,1810,1810,0,1810,1726,84,4280,4280,0,0,4280,4263,4229,13,4,8,0,9,17,17,0,0,0,0,4280,36,4244,4280,2171,2109,4229,42,16002
42,95,16100,1939962,2043,865,865,0,865,809,56,2043,2043,0,0,2043,2038,1991,8,7,24,0,8,5,4,1,0,0,0,2043,31,2012,2043,968,1075,1991,42,16100
42,95,16201,2880765,5348,2409,2409,0,2409,2291,118,5348,5348,0,0,5348,5316,5247,15,4,30,0,20,32,31,1,0,0,0,5348,117,5231,5348,2539,2809,5247,42,16201
42,95,16202,3849923,4057,1614,1614,0,1614,1578,36,4057,4057,0,0,4057,4037,3990,18,1,11,0,17,20,20,0,0,0,0,4057,47,4010,4057,1951,2106,3990,42,16202
42,95,16300,1905150,2814,1186,1186,0,1186,1136,50,2814,2814,0,0,2814,2792,2750,13,1,13,2,13,22,22,0,0,0,0,2814,51,2763,2814,1353,1461,2750,42,16300
42,95,16400,28726977,2630,1030,1030,0,1030,1001,29,2630,2630,0,0,2630,2616,2595,5,2,2,1,11,14,14,0,0,0,0,2630,29,2601,2630,1298,1332,2595,42,16400
42,95,16500,37362237,4903,1907,1907,0,1907,1864,43,4903,4903,0,0,4903,4873,4788,24,4,27,5,25,30,29,1,0,0,0,4903,84,4819,4903,2416,2487,4788,42,16500
42,95,16600,2342805,2678,1126,1126,0,1126,1061,65,2678,2678,0,0,2678,2646,2570,40,1,18,0,17,32,28,4,0,0,0,2678,47,2631,2678,1276,1402,2570,42,16600
42,95,16700,18983378,4426,1364,1364,0,1364,1327,37,4426,4426,0,0,4426,4409,4337,27,5,18,0,22,17,17,0,0,0,0,4426,65,4361,4426,1982,2444,4337,42,16700
42,95,16800,4328588,6023,2658,2658,0,2658,2560,98,6023,6023,0,0,6023,6009,5930,33,5,24,0,17,14,13,1,0,0,0,6023,57,5966,6023,2773,3250,5930,42,16800
42,95,16900,34703179,5259,1821,1821,0,1821,1788,33,5259,5259,0,0,5259,5226,5100,47,9,63,0,7,33,32,1,0,0,0,5259,73,5186,5259,2624,2635,5100,42,16900
42,95,17000,3926837,1617,649,649,0,649,631,18,1617,1617,0,0,1617,1613,1600,3,3,2,0,5,4,4,0,0,0,0,1617,11,1606,1617,763,854,1600,42,17000
42,95,17100,31231306,8419,3159,3159,0,3159,3035,124,8419,8419,0,0,8419,8354,7991,189,4,117,1,52,65,62,3,0,0,0,8419,173,8246,8419,4118,4301,7991,42,17100
42,95,17200,2479877,6367,2774,2774,0,2774,2605,169,6367,6367,0,0,6367,6266,5954,116,5,118,2,71,101,92,9,0,0,0,6367,254,6113,6367,3062,3305,5954,42,17200
42,95,17300,1547545,2467,1053,1053,0,1053,1011,42,2467,2467,0,0,2467,2442,2355,47,1,14,1,24,25,25,0,0,0,0,2467,100,2367,2467,1169,1298,2355,42,17300
42,95,17401,16083084,4640,1839,1839,0,1839,1793,46,4640,4640,0,0,4640,4582,4332,96,2,109,3,40,58,58,0,0,0,0,4640,131,4509,4640,2262,2378,4332,42,17401
42,95,17402,3487965,3870,1610,1610,0,1610,1582,28,3870,3870,0,0,3870,3851,3695,68,4,47,1,36,19,18,1,0,0,0,3870,108,3762,3870,1883,1987,3695,42,17402
42,95,17501,4187795,3790,1647,1647,0,1647,1615,32,3790,3790,0,0,3790,3742,3610,61,1,52,0,18,48,45,3,0,0,0,3790,76,3714,3790,1754,2036,3610,42,17501
42,95,17502,3962985,4509,1769,1769,0,1769,1726,43,4509,4509,0,0,4509,4467,4217,135,3,100,0,12,42,40,1,0,1,0,4509,78,4431,4509,2219,2290,4217,42,17502
42,95,17601,19868375,8311,3008,3008,0,3008,2918,90,8311,8311,0,0,8311,8245,7642,216,5,253,1,128,66,60,6,0,0,0,8311,370,7941,8311,3938,4373,7642,42,17601
42,95,17602,14734143,9009,3253,3253,0,3253,3181,72,9009,9009,0,0,9009,8929,8462,206,6,184,1,70,80,78,2,0,0,0,9009,268,8741,9009,4392,4617,8462,42,17602
42,95,17603,3169327,3851,1570,1570,0,1570,1520,50,3851,3851,0,0,3851,3812,3643,94,3,28,0,44,39,39,0,0,0,0,3851,202,3649,3851,1877,1974,3643,42,17603
42,95,17701,13331770,7422,2890,2890,0,2890,2805,85,7422,7422,0,0,7422,7348,6900,78,10,294,0,66,74,71,1,1,1,0,7422,183,7239,7422,3580,3842,6900,42,17701
42,95,17702,4132242,2141,839,839,0,839,828,11,2141,2141,0,0,2141,2101,2040,12,0,34,0,15,40,39,1,0,0,0,2141,54,2087,2141,1055,1086,2040,42,17702
42,95,17800,1889368,1897,721,721,0,721,687,34,1897,1897,0,0,1897,1841,1664,53,6,9,0,109,56,55,1,0,0,0,1897,282,1615,1897,957,940,1664,42,17800
42,95,17901,1963021,3383,1596,1596,0,1596,1498,98,3383,3383,0,0,3383,3367,3315,14,3,10,0,25,16,16,0,0,0,0,3383,96,3287,3383,1592,1791,3315,42,17901
42,95,17902,1509851,2223,974,974,0,974,950,24,2223,2223,0,0,2223,2208,2190,3,1,1,0,13,15,14,1,0,0,0,2223,43,2180,2223,1053,1170,2190,42,17902
42,95,18001,42839369,3923,1485,1485,0,1485,1427,58,3923,3923,0,0,3923,3887,3817,11,5,18,6,30,36,32,4,0,0,0,3923,110,3813,3923,2003,1920,3817,42,18001
42,95,18002,19690311,5961,2430,2430,0,2430,2308,122,5961,5961,0,0,5961,5938,5744,44,11,101,0,38,23,22,0,0,1,0,5961,143,5818,5961,2907,3054,5744,42,18002
42,95,18100,49291259,4837,1888,1888,0,1888,1796,92,4837,4837,0,0,4837,4794,4698,39,2,47,1,7,43,40,3,0,0,0,4837,55,4782,4837,2420,2417,4698,42,18100
42,97,960100,105250812,4230,1657,1657,0,1657,1588,69,4230,4230,0,0,4230,4212,4169,25,2,8,1,7,18,17,1,0,0,0,4230,18,4212,4230,2118,2112,4169,42,960100
42,97,960200,80946915,6910,2905,2905,0,2905,2761,144,6910,6910,0,0,6910,6886,6823,26,12,13,4,8,24,24,0,0,0,0,6910,32,6878,6910,3284,3626,6823,42,960200
42,97,960300,9047732,6659,3006,3006,0,3006,2768,238,6659,6659,0,0,6659,6557,6314,158,8,14,0,63,102,93,9,0,0,0,6659,144,6515,6659,3131,3528,6314,42,960300
42,97,960400,54014108,3488,1549,1549,0,1549,1462,87,3488,3488,0,0,3488,3475,3433,20,4,4,2,12,13,12,1,0,0,0,3488,18,3470,3488,1759,1729,3433,42,960400
42,97,960500,65524776,3735,1528,1528,0,1528,1448,80,3735,3735,0,0,3735,3720,3681,13,8,14,0,4,15,15,0,0,0,0,3735,26,3709,3735,1807,1928,3681,42,960500
42,97,960600,4061848,3714,1772,1772,0,1772,1657,115,3714,3714,0,0,3714,3708,3654,27,5,7,0,15,6,6,0,0,0,0,3714,23,3691,3714,1760,1954,3654,42,960600
42,97,960700,81869738,3050,1268,1268,0,1268,1203,65,3050,3050,0,0,3050,3035,3014,4,0,12,1,4,15,15,0,0,0,0,3050,15,3035,3050,1494,1556,3014,42,960700
42,97,960800,137226624,6280,2649,2649,0,2649,2484,165,6280,6280,0,0,6280,6267,6237,7,3,16,0,4,13,13,0,0,0,0,6280,21,6259,6280,3121,3159,6237,42,960800
42,97,960900,56991242,3436,1625,1625,0,1625,1400,225,3436,3436,0,0,3436,3425,3419,0,1,3,1,1,11,11,0,0,0,0,3436,6,3430,3436,1617,1819,3419,42,960900
42,97,961000,900667,3448,1916,1916,0,1916,1626,290,3448,3448,0,0,3448,3427,3409,1,5,8,1,3,21,19,2,0,0,0,3448,19,3429,3448,1629,1819,3409,42,961000
42,97,961100,813361,2942,1713,1713,0,1713,1409,304,2942,2942,0,0,2942,2920,2889,3,5,10,0,13,22,16,0,4,2,0,2942,38,2904,2942,1360,1582,2889,42,961100
42,97,961200,65330115,5608,1752,1752,0,1752,1513,239,5608,5608,0,0,5608,5567,4540,950,5,14,0,58,41,38,3,0,0,0,5608,210,5398,5608,3605,2003,4540,42,961200
42,97,961300,1287418,2619,1318,1318,0,1318,1184,134,2619,2619,0,0,2619,2604,2583,4,1,12,0,4,15,12,3,0,0,0,2619,10,2609,2619,1218,1401,2583,42,961300
42,97,961400,1998491,2401,1163,1163,0,1163,1035,128,2401,2401,0,0,2401,2394,2383,5,1,2,0,3,7,7,0,0,0,0,2401,3,2398,2401,1142,1259,2383,42,961400
42,97,961500,657585,2489,1527,1527,0,1527,1220,307,2489,2489,0,0,2489,2473,2448,1,2,15,0,7,16,16,0,0,0,0,2489,23,2466,2489,1164,1325,2448,42,961500
42,97,961600,728108,3013,1704,1704,0,1704,1363,341,3013,3013,0,0,3013,2997,2981,2,6,4,1,3,16,16,0,0,0,0,3013,21,2992,3013,1387,1626,2981,42,961600
42,97,961700,774640,2507,1443,1443,0,1443,1159,284,2507,2507,0,0,2507,2501,2487,7,0,6,0,1,6,6,0,0,0,0,2507,8,2499,2507,1156,1351,2487,42,961700
42,97,961800,118490372,3659,1611,1611,0,1611,1481,130,3659,3659,0,0,3659,3641,3626,4,3,5,0,3,18,18,0,0,0,0,3659,18,3641,3659,1841,1818,3626,42,961800
42,97,961900,153182727,5856,2351,2351,0,2351,2259,92,5856,5856,0,0,5856,5823,5774,16,3,10,3,17,33,29,4,0,0,0,5856,27,5829,5856,2924,2932,5774,42,961900
42,97,962000,1945052,3844,1803,1803,0,1803,1664,139,3844,3844,0,0,3844,3789,3608,62,5,21,0,93,55,48,7,0,0,0,3844,148,3696,3844,1788,2056,3608,42,962000
42,97,962100,850566,2779,1450,1450,0,1450,1273,177,2779,2779,0,0,2779,2754,2675,38,3,4,0,34,25,25,0,0,0,0,2779,60,2719,2779,1356,1423,2675,42,962100
42,97,962200,2703492,3987,1819,1819,0,1819,1603,216,3987,3987,0,0,3987,3949,3824,37,7,3,2,76,38,36,2,0,0,0,3987,120,3867,3987,1809,2178,3824,42,962200
42,97,962300,244142876,4917,2103,2103,0,2103,1937,166,4917,4917,0,0,4917,4905,4880,15,1,5,0,4,12,12,0,0,0,0,4917,17,4900,4917,2474,2443,4880,42,962300
42,97,962400,2423818,2985,1532,1532,0,1532,1338,194,2985,2985,0,0,2985,2974,2952,14,0,1,0,7,11,11,0,0,0,0,2985,16,2969,2985,1431,1554,2952,42,962400
42,99,30100,200501451,4653,2092,2092,0,2092,1837,255,4653,4653,0,0,4653,4632,4586,29,5,10,0,2,21,17,4,0,0,0,4653,35,4618,4653,2278,2375,4586,42,30100
42,99,30200,182588098,7500,3311,3311,0,3311,2933,378,7500,7500,0,0,7500,7455,7387,18,13,13,0,24,45,43,1,1,0,0,7500,66,7434,7500,3688,3812,7387,42,30200
42,99,30301,56630643,4521,1956,1956,0,1956,1826,130,4521,4521,0,0,4521,4491,4451,17,6,4,1,12,30,30,0,0,0,0,4521,34,4487,4521,2176,2345,4451,42,30301
42,99,30302,84572879,4648,1824,1824,0,1824,1710,114,4648,4648,0,0,4648,4630,4605,8,4,11,0,2,18,17,1,0,0,0,4648,29,4619,4648,2343,2305,4605,42,30302
42,99,30400,72516131,4633,1975,1975,0,1975,1877,98,4633,4633,0,0,4633,4601,4575,9,0,10,0,7,32,30,2,0,0,0,4633,18,4615,4633,2231,2402,4575,42,30400
42,99,30501,89112066,5095,2036,2036,0,2036,1897,139,5095,5095,0,0,5095,5075,5041,13,6,3,1,11,20,20,0,0,0,0,5095,31,5064,5095,2543,2552,5041,42,30501
42,99,30502,154235302,5307,2137,2137,0,2137,1985,152,5307,5307,0,0,5307,5287,5244,17,7,7,1,11,20,20,0,0,0,0,5307,25,5282,5307,2624,2683,5244,42,30502
42,99,30601,212007261,4262,1908,1908,0,1908,1600,308,4262,4262,0,0,4262,4234,4190,23,8,5,1,7,28,25,3,0,0,0,4262,33,4229,4262,2153,2109,4190,42,30601
42,99,30602,381438399,2983,1702,1702,0,1702,1030,672,2983,2983,0,0,2983,2963,2885,55,4,2,1,16,20,17,3,0,0,0,2983,30,2953,2983,1584,1399,2885,42,30602
42,101,100,713478,2650,1900,1900,0,1900,1748,152,2650,2650,0,0,2650,2601,2128,338,6,104,0,25,49,43,6,0,0,0,2650,92,2558,2650,1494,1156,2128,42,100
42,101,200,405844,1362,509,509,0,509,459,50,1362,1362,0,0,1362,1327,162,74,1,1085,1,4,35,33,1,1,0,0,1362,23,1339,1362,683,679,162,42,200
42,101,300,563071,2570,1392,1392,0,1392,1239,153,2570,2570,0,0,2570,2481,1886,379,8,180,2,26,89,85,4,0,0,0,2570,98,2472,2570,1223,1347,1886,42,300
42,101,400,521372,4313,3268,3268,0,3268,2999,269,4313,4313,0,0,4313,4234,3263,552,8,369,2,40,79,73,5,1,0,0,4313,122,4191,4313,1744,2569,3263,42,400
42,101,500,431280,1126,373,373,0,373,280,93,1126,1126,0,0,1126,1109,623,320,2,143,0,21,17,17,0,0,0,0,1126,58,1068,1126,681,445,623,42,500
42,101,600,168125,1315,624,624,0,624,521,103,1315,1315,0,0,1315,1275,915,209,0,140,0,11,40,31,9,0,0,0,1315,45,1270,1315,873,442,915,42,600
42,101,700,252815,2564,2044,2044,0,2044,1890,154,2564,2564,0,0,2564,2498,2038,151,2,282,2,23,66,55,11,0,0,0,2564,117,2447,2564,1207,1357,2038,42,700
42,101,800,399716,8461,6567,6567,0,6567,6115,452,8461,8461,0,0,8461,8331,7133,266,3,855,4,70,130,115,14,1,0,0,8461,296,8165,8461,4049,4412,7133,42,800
42,101,900,261466,4969,3411,3411,0,3411,3195,216,4969,4969,0,0,4969,4862,3474,460,17,835,1,75,107,101,4,1,1,0,4969,211,4758,4969,2470,2499,3474,42,900
42,101,1000,705692,5808,3869,3869,0,3869,3635,234,5808,5808,0,0,5808,5754,5290,182,6,221,2,53,54,52,2,0,0,0,5808,144,5664,5808,2794,3014,5290,42,1000
42,101,1100,374636,5925,4092,4092,0,4092,3857,235,5925,5925,0,0,5925,5778,4773,578,14,354,2,57,147,129,17,1,0,0,5925,231,5694,5925,3095,2830,4773,42,1100
42,101,1200,644762,8148,5451,5451,0,5451,4973,478,8148,8148,0,0,8148,8024,7000,483,16,430,1,94,124,121,3,0,0,0,8148,307,7841,8148,4179,3969,7000,42,1200
42,101,1300,721568,4353,2293,2293,0,2293,1922,371,4353,4353,0,0,4353,4275,982,3167,7,58,0,61,78,68,9,1,0,0,4353,97,4256,4353,2079,2274,982,42,1300
42,101,1400,318964,3585,2270,2270,0,2270,1929,341,3585,3585,0,0,3585,3490,1172,2129,24,114,3,48,95,87,7,0,1,0,3585,135,3450,3585,1866,1719,1172,42,1400
42,101,1500,239512,2179,1255,1255,0,1255,1135,120,2179,2179,0,0,2179,2097,1375,576,9,102,5,30,82,71,11,0,0,0,2179,86,2093,2179,1176,1003,1375,42,1500
42,101,1600,199559,1981,1244,1244,0,1244,1122,122,1981,1981,0,0,1981,1926,1653,162,1,71,3,36,55,48,6,1,0,0,1981,93,1888,1981,1043,938,1653,42,1600
42,101,1700,205748,2415,1500,1500,0,1500,1365,135,2415,2415,0,0,2415,2368,1905,383,9,50,0,21,47,45,1,1,0,0,2415,84,2331,2415,1191,1224,1905,42,1700
42,101,1800,239288,2398,1318,1318,0,1318,1208,110,2398,2398,0,0,2398,2334,1645,525,6,134,0,24,64,49,14,0,1,0,2398,70,2328,2398,1138,1260,1645,42,1800
42,101,1900,328120,2686,1381,1381,0,1381,1061,320,2686,2686,0,0,2686,2635,119,2407,12,36,2,59,51,46,5,0,0,0,2686,118,2568,2686,1274,1412,119,42,1900
42,101,2000,289664,2334,1066,1066,0,1066,890,176,2334,2334,0,0,2334,2319,22,2266,10,20,0,1,15,11,4,0,0,0,2334,11,2323,2334,1051,1283,22,42,2000
42,101,2100,238214,2340,1149,1149,0,1149,883,266,2340,2340,0,0,2340,2308,41,2238,16,13,0,0,32,24,8,0,0,0,2340,15,2325,2340,1022,1318,41,42,2100
42,101,2200,235397,2182,1194,1194,0,1194,928,266,2182,2182,0,0,2182,2145,283,1752,6,74,0,30,37,33,4,0,0,0,2182,88,2094,2182,1057,1125,283,42,2200
42,101,2300,211493,2480,1302,1302,0,1302,1145,157,2480,2480,0,0,2480,2407,1750,221,2,396,1,37,73,72,1,0,0,0,2480,115,2365,2480,1230,1250,1750,42,2300
42,101,2400,536354,4426,2362,2362,0,2362,2028,334,4426,4426,0,0,4426,4318,2654,779,10,796,0,79,108,98,8,2,0,0,4426,274,4152,4426,2193,2233,2654,42,2400
42,101,2500,398533,3149,1640,1640,0,1640,1367,273,3149,3149,0,0,3149,3060,1546,1380,8,102,0,24,89,81,7,1,0,0,3149,133,3016,3149,1495,1654,1546,42,2500
42,101,2600,460257,0,1,1,0,1,0,1,0,0,0,0,0,0,0,0,0,0,0,0,0,0,0,0,0,0,0,0,0,0,0,0,0,42,2600
42,101,2700,593414,7658,3505,3505,0,3505,2975,530,7658,7658,0,0,7658,7464,4312,1674,18,1119,9,332,194,185,8,1,0,0,7658,683,6975,7658,3598,4060,4312,42,2700
42,101,2800,593235,9255,4117,4117,0,4117,3643,474,9255,9255,0,0,9255,8971,5569,719,17,2369,10,287,284,280,4,0,0,0,9255,701,8554,9255,4347,4908,5569,42,2800
42,101,2900,364775,4050,2167,2167,0,2167,1979,188,4050,4050,0,0,4050,3933,3557,82,7,213,1,73,117,117,0,0,0,0,4050,181,3869,4050,1930,2120,3557,42,2900
42,101,3000,469448,8160,3314,3314,0,3314,2811,503,8160,8160,0,0,8160,7956,1203,3986,16,2625,12,114,204,197,7,0,0,0,8160,244,7916,8160,3871,4289,1203,42,3000
42,101,3100,395528,5161,2527,2527,0,2527,1993,534,5161,5161,0,0,5161,5101,55,4932,15,75,3,21,60,53,7,0,0,0,5161,44,5117,5161,2289,2872,55,42,3100
42,101,3200,493303,5587,2357,2357,0,2357,1956,401,5587,5587,0,0,5587,5500,479,4968,18,19,0,16,87,78,8,1,0,0,5587,58,5529,5587,2441,3146,479,42,3200
42,101,3300,740310,6235,2603,2603,0,2603,2224,379,6235,6235,0,0,6235,6164,2633,3437,10,30,0,54,71,63,6,1,1,0,6235,113,6122,6235,2775,3460,2633,42,3300
42,101,3400,547294,363,202,202,0,202,162,40,363,363,0,0,363,362,88,153,0,121,0,0,1,1,0,0,0,0,363,6,357,363,173,190,88,42,3400
42,101,3500,1697729,126,78,78,0,78,58,20,126,126,0,0,126,124,94,29,0,0,0,1,2,1,1,0,0,0,126,1,125,126,58,68,94,42,3500
42,101,3600,889844,5724,3073,3073,0,3073,2401,672,5724,5724,0,0,5724,5632,2035,3358,3,206,3,27,92,80,11,1,0,0,5724,95,5629,5724,2402,3322,2035,42,3600
42,101,3701,359119,7061,2631,2631,0,2631,2315,316,7061,7061,0,0,7061,6939,865,5385,18,602,2,67,122,114,7,1,0,0,7061,113,6948,7061,3072,3989,865,42,3701
42,101,3702,251713,3372,1461,1461,0,1461,1360,101,3372,3372,0,0,3372,3311,1954,1128,8,196,3,22,61,60,1,0,0,0,3372,77,3295,3372,1542,1830,1954,42,3702
42,101,3800,689756,3851,1721,1721,0,1721,1652,69,3851,3851,0,0,3851,3782,3658,65,4,44,0,11,69,68,1,0,0,0,3851,49,3802,3851,1769,2082,3658,42,3800
42,101,3901,430434,6192,2916,2916,0,2916,2681,235,6192,6192,0,0,6192,6103,4712,693,16,610,1,71,89,82,7,0,0,0,6192,176,6016,6192,2891,3301,4712,42,3901
42,101,3902,467092,5630,2588,2588,0,2588,2435,153,5630,5630,0,0,5630,5587,5539,4,3,34,0,7,43,43,0,0,0,0,5630,70,5560,5630,2639,2991,5539,42,3902
42,101,4001,315874,4036,2079,2079,0,2079,1877,202,4036,4036,0,0,4036,3938,3725,46,13,113,1,40,98,97,0,1,0,0,4036,136,3900,4036,1868,2168,3725,42,4001
42,101,4002,331227,5024,2320,2320,0,2320,2193,127,5024,5024,0,0,5024,4981,4932,16,3,18,0,12,43,43,0,0,0,0,5024,91,4933,5024,2264,2760,4932,42,4002
42,101,4101,382086,5737,2470,2470,0,2470,2018,452,5737,5737,0,0,5737,5503,2021,1876,24,1419,0,163,234,223,11,0,0,0,5737,336,5401,5737,2710,3027,2021,42,4101
42,101,4102,392855,7316,2999,2999,0,2999,2665,334,7316,7316,0,0,7316,7075,4804,828,19,1281,20,123,241,234,5,0,0,2,7316,355,6961,7316,3524,3792,4804,42,4102
42,101,4201,360974,5449,2317,2317,0,2317,2087,230,5449,5449,0,0,5449,5337,4365,512,7,361,5,87,112,110,2,0,0,0,5449,268,5181,5449,2544,2905,4365,42,4201
42,101,4202,443043,5053,1926,1926,0,1926,1775,151,5053,5053,0,0,5053,4959,4370,275,12,262,7,33,94,91,0,3,0,0,5053,120,4933,5053,2392,2661,4370,42,4202
42,101,4300,1885301,0,0,0,0,0,0,0,0,0,0,0,0,0,0,0,0,0,0,0,0,0,0,0,0,0,0,0,0,0,0,0,0,42,4300
42,101,4400,577594,1088,443,443,0,443,393,50,1088,1088,0,0,1088,1061,624,276,0,149,1,11,27,26,1,0,0,0,1088,46,1042,1088,485,603,624,42,4400
42,101,4500,497488,3066,1431,1431,0,1431,1379,52,3066,3066,0,0,3066,3022,2950,14,1,36,0,21,44,44,0,0,0,0,3066,32,3034,3066,1407,1659,2950,42,4500
42,101,4600,3738089,185,652,652,0,652,68,584,185,185,0,0,185,177,12,160,2,1,0,2,8,8,0,0,0,0,185,6,179,185,79,106,12,42,4600
42,101,4700,834342,2561,1522,1522,0,1522,1105,417,2561,2561,0,0,2561,2545,2474,48,1,13,0,9,16,16,0,0,0,0,2561,19,2542,2561,1199,1362,2474,42,4700
42,101,4800,453752,472,221,221,0,221,215,6,472,472,0,0,472,471,469,2,0,0,0,0,1,1,0,0,0,0,472,0,472,472,211,261,469,42,4800
42,101,4900,4421765,0,0,0,0,0,0,0,0,0,0,0,0,0,0,0,0,0,0,0,0,0,0,0,0,0,0,0,0,0,0,0,0,42,4900
42,101,5000,4477136,0,340,340,0,340,0,340,0,0,0,0,0,0,0,0,0,0,0,0,0,0,0,0,0,0,0,0,0,0,0,0,0,42,5000
42,101,5100,2429968,611,514,514,0,514,372,142,611,611,0,0,611,595,151,400,2,31,0,11,16,14,2,0,0,0,611,28,583,611,322,289,151,42,5100
42,101,5200,8466490,1,0,0,0,0,0,0,1,1,0,0,1,1,1,0,0,0,0,0,0,0,0,0,0,0,1,0,1,1,1,0,1,42,5200
42,101,5400,1767086,1248,691,691,0,691,598,93,1248,1248,0,0,1248,1223,151,1036,3,24,0,9,25,19,6,0,0,0,1248,27,1221,1248,616,632,151,42,5400
42,101,5500,1200066,5777,2473,2473,0,2473,2354,119,5777,5777,0,0,5777,5651,1717,3735,10,135,2,52,126,116,10,0,0,0,5777,131,5646,5777,2687,3090,1717,42,5500
42,101,5600,839138,1230,577,577,0,577,545,32,1230,1230,0,0,1230,1213,86,1092,5,18,0,12,17,14,3,0,0,0,1230,32,1198,1230,524,706,86,42,5600
42,101,5700,1288775,0,0,0,0,0,0,0,0,0,0,0,0,0,0,0,0,0,0,0,0,0,0,0,0,0,0,0,0,0,0,0,0,42,5700
42,101,5800,3755529,0,0,0,0,0,0,0,0,0,0,0,0,0,0,0,0,0,0,0,0,0,0,0,0,0,0,0,0,0,0,0,0,42,5800
42,101,5900,390757,0,0,0,0,0,0,0,0,0,0,0,0,0,0,0,0,0,0,0,0,0,0,0,0,0,0,0,0,0,0,0,0,42,5900
42,101,6000,1086456,6127,2642,2642,0,2642,2476,166,6127,6127,0,0,6127,5976,3333,2405,10,201,0,27,151,137,13,0,1,0,6127,85,6042,6127,2794,3333,3333,42,6000
42,101,6100,534974,2957,1202,1202,0,1202,1157,45,2957,2957,0,0,2957,2908,1580,1189,2,111,0,26,49,48,1,0,0,0,2957,52,2905,2957,1371,1586,1580,42,6100
42,101,6200,505813,4127,1600,1600,0,1600,1459,141,4127,4127,0,0,4127,4053,1980,1752,18,272,0,31,74,67,4,3,0,0,4127,77,4050,4127,1926,2201,1980,42,6200
42,101,6300,555191,4546,1730,1730,0,1730,1428,302,4546,4546,0,0,4546,4438,694,2959,5,749,0,31,108,102,6,0,0,0,4546,112,4434,4546,2171,2375,694,42,6300
42,101,6400,660331,4658,1672,1672,0,1672,1490,182,4658,4658,0,0,4658,4533,956,2777,15,760,0,25,125,112,13,0,0,0,4658,108,4550,4658,2175,2483,956,42,6400
42,101,6500,1159143,5231,2249,2249,0,2249,1852,397,5231,5231,0,0,5231,5172,52,5053,10,32,7,18,59,47,11,1,0,0,5231,69,5162,5231,2337,2894,52,42,6500
42,101,6600,656719,3979,1595,1595,0,1595,1339,256,3979,3979,0,0,3979,3870,478,2799,10,566,2,15,109,106,2,1,0,0,3979,99,3880,3979,1764,2215,478,42,6600
42,101,6700,998660,6991,2769,2769,0,2769,2485,284,6991,6991,0,0,6991,6865,2830,3582,6,369,2,76,126,120,6,0,0,0,6991,164,6827,6991,3191,3800,2830,42,6700
42,101,6800,743960,1,1,1,0,1,1,0,1,1,0,0,1,0,0,0,0,0,0,0,1,1,0,0,0,0,1,0,1,1,1,0,0,42,6800
42,101,6900,691145,2710,1125,1125,0,1125,1026,99,2710,2710,0,0,2710,2688,114,2546,3,1,1,23,22,20,2,0,0,0,2710,21,2689,2710,1085,1625,114,42,6900
42,101,7000,466727,4588,1850,1850,0,1850,1542,308,4588,4588,0,0,4588,4527,33,4424,15,29,0,26,61,49,10,2,0,0,4588,43,4545,4588,2018,2570,33,42,7000
42,101,7100,672090,8310,3227,3227,0,3227,2753,474,8310,8310,0,0,8310,8164,188,7848,13,61,6,48,146,127,9,10,0,0,8310,112,8198,8310,3674,4636,188,42,7100
42,101,7200,488103,5421,2127,2127,0,2127,1825,302,5421,5421,0,0,5421,5353,82,5214,10,21,0,26,68,68,0,0,0,0,5421,62,5359,5421,2384,3037,82,42,7200
42,101,7300,392081,3255,1366,1366,0,1366,1093,273,3255,3255,0,0,3255,3200,37,3105,9,40,0,9,55,48,7,0,0,0,3255,36,3219,3255,1482,1773,37,42,7300
42,101,7400,675281,4559,2077,2077,0,2077,1645,432,4559,4559,0,0,4559,4463,98,4296,13,43,2,11,96,94,1,1,0,0,4559,36,4523,4559,2026,2533,98,42,7400
42,101,7500,418043,0,0,0,0,0,0,0,0,0,0,0,0,0,0,0,0,0,0,0,0,0,0,0,0,0,0,0,0,0,0,0,0,42,7500
42,101,7600,1004150,2419,2,2,0,2,2,0,2419,2419,0,0,2419,2371,1458,344,0,502,0,67,48,47,1,0,0,0,2419,143,2276,2419,1474,945,1458,42,7600
42,101,7700,322756,1850,888,888,0,888,802,86,1850,1850,0,0,1850,1803,612,857,13,295,0,26,47,39,8,0,0,0,1850,51,1799,1850,847,1003,612,42,7700
42,101,7800,435912,4690,2421,2421,0,2421,2118,303,4690,4690,0,0,4690,4464,1339,2901,14,164,4,42,226,215,11,0,0,0,4690,125,4565,4690,2256,2434,1339,42,7800
42,101,7900,378232,4777,2392,2392,0,2392,2150,242,4777,4777,0,0,4777,4618,1309,3037,9,200,3,60,159,153,6,0,0,0,4777,129,4648,4777,2360,2417,1309,42,7900
42,101,8000,427154,4481,1962,1962,0,1962,1612,350,4481,4481,0,0,4481,4430,92,4289,8,31,0,10,51,48,1,2,0,0,4481,35,4446,4481,2007,2474,92,42,8000
42,101,8100,614663,8288,3299,3299,0,3299,3020,279,8288,8288,0,0,8288,8146,52,8020,10,29,1,34,142,127,14,0,1,0,8288,73,8215,8288,3532,4756,52,42,8100
42,101,8200,832845,7297,2960,2960,0,2960,2724,236,7297,7297,0,0,7297,7175,64,7025,21,40,2,23,122,98,20,2,2,0,7297,83,7214,7297,3208,4089,64,42,8200
42,101,8301,515960,4420,1942,1942,0,1942,1748,194,4420,4420,0,0,4420,4361,113,4151,14,60,1,22,59,49,6,2,2,0,4420,60,4360,4420,1915,2505,113,42,8301
42,101,8302,427987,4535,2204,2204,0,2204,1814,390,4535,4535,0,0,4535,4465,58,4357,11,22,0,17,70,63,6,1,0,0,4535,60,4475,4535,1974,2561,58,42,8302
42,101,8400,496792,4798,2052,2052,0,2052,1791,261,4798,4798,0,0,4798,4708,56,4617,11,14,2,8,90,78,10,2,0,0,4798,32,4766,4798,2060,2738,56,42,8400
42,101,8500,622072,6539,3166,3166,0,3166,2639,527,6539,6539,0,0,6539,6411,56,6241,22,52,2,38,128,120,6,2,0,0,6539,88,6451,6539,2813,3726,56,42,8500
42,101,8600,625431,6224,3335,3335,0,3335,2848,487,6224,6224,0,0,6224,6030,949,4720,8,300,1,52,194,177,13,4,0,0,6224,163,6061,6224,2877,3347,949,42,8600
42,101,8700,541792,6733,3791,3791,0,3791,3391,400,6733,6733,0,0,6733,6412,3072,1957,28,1246,3,106,321,309,12,0,0,0,6733,235,6498,6733,3496,3237,3072,42,8700
42,101,8800,570696,8307,2445,2445,0,2445,2148,297,8307,8307,0,0,8307,8095,4795,1107,14,2025,6,148,212,205,7,0,0,0,8307,344,7963,8307,4292,4015,4795,42,8800
42,101,8900,873888,3226,499,499,0,499,491,8,3226,3226,0,0,3226,3165,1622,474,7,977,7,78,61,58,3,0,0,0,3226,176,3050,3226,1625,1601,1622,42,8900
42,101,9000,450386,5452,1637,1637,0,1637,1572,65,5452,5452,0,0,5452,5249,3562,992,18,598,21,58,203,196,7,0,0,0,5452,208,5244,5452,3045,2407,3562,42,9000
42,101,9100,421935,2812,1619,1619,0,1619,1482,137,2812,2812,0,0,2812,2732,836,1521,18,302,5,50,80,74,6,0,0,0,2812,90,2722,2812,1371,1441,836,42,9100
42,101,9200,514519,3075,1447,1447,0,1447,1142,305,3075,3075,0,0,3075,3011,74,2869,7,49,0,12,64,58,5,0,1,0,3075,39,3036,3075,1368,1707,74,42,9200
42,101,9300,402721,4609,2296,2296,0,2296,1843,453,4609,4609,0,0,4609,4566,29,4489,13,6,1,28,43,41,2,0,0,0,4609,41,4568,4609,2030,2579,29,42,9300
42,101,9400,373494,3871,1970,1970,0,1970,1659,311,3871,3871,0,0,3871,3809,18,3753,20,5,2,11,62,51,10,1,0,0,3871,34,3837,3871,1616,2255,18,42,9400
42,101,9500,324353,3588,1666,1666,0,1666,1366,300,3588,3588,0,0,3588,3548,12,3500,18,6,2,10,40,34,6,0,0,0,3588,28,3560,3588,1572,2016,12,42,9500
42,101,9600,408934,4504,2102,2102,0,2102,1717,385,4504,4504,0,0,4504,4446,71,4317,10,43,0,5,58,49,9,0,0,0,4504,32,4472,4504,2008,2496,71,42,9600
42,101,9700,2133199,35,18,18,0,18,18,0,35,35,0,0,35,35,22,13,0,0,0,0,0,0,0,0,0,0,35,1,34,35,19,16,22,42,9700
42,101,9800,904480,7768,3260,3260,0,3260,3105,155,7768,7768,0,0,7768,7527,2578,4566,27,284,0,72,241,223,9,8,1,0,7768,157,7611,7768,3506,4262,2578,42,9800
42,101,9900,206222,381,142,142,0,142,140,2,381,381,0,0,381,379,218,153,0,8,0,0,2,2,0,0,0,0,381,1,380,381,171,210,218,42,9900
42,101,10000,552742,4218,1775,1775,0,1775,1614,161,4218,4218,0,0,4218,4141,1435,2539,16,82,0,69,77,71,6,0,0,0,4218,157,4061,4218,1901,2317,1435,42,10000
42,101,10100,603280,5841,2659,2659,0,2659,2260,399,5841,5841,0,0,5841,5713,166,5455,21,32,0,39,128,115,13,0,0,0,5841,111,5730,5841,2558,3283,166,42,10100
42,101,10200,358476,3208,1470,1470,0,1470,1284,186,3208,3208,0,0,3208,3126,9,3091,4,11,0,11,82,72,10,0,0,0,3208,39,3169,3208,1404,1804,9,42,10200
42,101,10300,283120,2588,1224,1224,0,1224,988,236,2588,2588,0,0,2588,2556,27,2492,13,13,1,10,32,29,3,0,0,0,2588,22,2566,2588,1111,1477,27,42,10300
42,101,10400,467647,3498,1522,1522,0,1522,1283,239,3498,3498,0,0,3498,3456,19,3412,3,5,0,17,42,30,10,0,2,0,3498,32,3466,3498,1494,2004,19,42,10400
42,101,10500,664028,3503,1688,1688,0,1688,1285,403,3503,3503,0,0,3503,3474,71,3362,13,17,2,9,29,20,9,0,0,0,3503,39,3464,3503,1457,2046,71,42,10500
42,101,10600,258496,1565,756,756,0,756,613,143,1565,1565,0,0,1565,1526,19,1498,6,1,0,2,39,36,3,0,0,0,1565,18,1547,1565,695,870,19,42,10600
42,101,10700,462992,3671,1639,1639,0,1639,1276,363,3671,3671,0,0,3671,3641,45,3556,9,6,11,14,30,25,5,0,0,0,3671,46,3625,3671,1619,2052,45,42,10700
42,101,10800,559249,4273,1845,1845,0,1845,1460,385,4273,4273,0,0,4273,4202,62,4074,30,23,2,11,71,66,5,0,0,0,4273,70,4203,4273,1872,2401,62,42,10800
42,101,10900,255737,2553,1101,1101,0,1101,985,116,2553,2553,0,0,2553,2507,83,2370,18,24,1,11,46,43,3,0,0,0,2553,19,2534,2553,1106,1447,83,42,10900
42,101,11000,488980,3817,2007,2007,0,2007,1527,480,3817,3817,0,0,3817,3779,66,3669,5,15,3,21,38,33,5,0,0,0,3817,63,3754,3817,1759,2058,66,42,11000
42,101,11100,1316710,4204,1961,1961,0,1961,1502,459,4204,4204,0,0,4204,4128,106,3982,10,18,5,7,76,62,14,0,0,0,4204,43,4161,4204,1867,2337,106,42,11100
42,101,11200,506361,6107,2506,2506,0,2506,2208,298,6107,6107,0,0,6107,6012,33,5924,13,17,4,21,95,76,17,0,2,0,6107,94,6013,6107,2653,3454,33,42,11200
42,101,11300,345034,3132,1381,1381,0,1381,1213,168,3132,3132,0,0,3132,3081,18,3038,11,6,0,8,51,43,8,0,0,0,3132,36,3096,3132,1337,1795,18,42,11300
42,101,11400,976261,6612,2976,2976,0,2976,2659,317,6612,6612,0,0,6612,6511,249,6178,23,32,1,28,101,88,13,0,0,0,6612,58,6554,6612,2939,3673,249,42,11400
42,101,11500,359134,4274,1706,1706,0,1706,1556,150,4274,4274,0,0,4274,4168,1110,2979,4,45,1,29,106,88,16,2,0,0,4274,83,4191,4274,1922,2352,1110,42,11500
42,101,11600,747363,4033,1423,1423,0,1423,1346,77,4033,4033,0,0,4033,3939,2468,1275,4,148,1,43,94,86,8,0,0,0,4033,120,3913,4033,1908,2125,2468,42,11600
42,101,11700,664749,2738,504,504,0,504,488,16,2738,2738,0,0,2738,2695,1785,836,8,52,0,14,43,40,3,0,0,0,2738,70,2668,2738,1220,1518,1785,42,11700
42,101,11800,938645,5987,2324,2324,0,2324,2181,143,5987,5987,0,0,5987,5861,106,5713,20,9,0,13,126,117,6,3,0,0,5987,48,5939,5987,2670,3317,106,42,11800
42,101,11900,695411,5596,2448,2448,0,2448,2203,245,5596,5596,0,0,5596,5471,120,5275,11,38,2,25,125,105,9,11,0,0,5596,65,5531,5596,2504,3092,120,42,11900
42,101,12000,599778,1661,759,759,0,759,721,38,1661,1661,0,0,1661,1617,401,1139,5,59,0,13,44,34,10,0,0,0,1661,28,1633,1661,835,826,401,42,12000
42,101,12100,893865,3340,1453,1453,0,1453,1392,61,3340,3340,0,0,3340,3245,1119,1970,11,92,6,47,95,77,18,0,0,0,3340,107,3233,3340,1390,1950,1119,42,12100
42,101,12200,1430152,8016,5601,5601,0,5601,4856,745,8016,8016,0,0,8016,7814,3973,2988,23,754,10,66,202,171,30,1,0,0,8016,228,7788,8016,3187,4829,3973,42,12200
42,101,12300,5513258,16,1,1,0,1,1,0,16,16,0,0,16,16,14,2,0,0,0,0,0,0,0,0,0,0,16,0,16,16,8,8,14,42,12300
42,101,12400,1179331,0,0,0,0,0,0,0,0,0,0,0,0,0,0,0,0,0,0,0,0,0,0,0,0,0,0,0,0,0,0,0,0,42,12400
42,101,12500,834652,4352,3002,3002,0,3002,2651,351,4352,4352,0,0,4352,4259,3069,646,11,449,0,84,93,83,10,0,0,0,4352,209,4143,4352,1971,2381,3069,42,12500
42,101,12600,365187,835,436,436,0,436,351,85,835,835,0,0,835,809,355,309,2,127,0,16,26,22,4,0,0,0,835,67,768,835,513,322,355,42,12600
42,101,12700,339249,727,272,272,0,272,255,17,727,727,0,0,727,719,44,435,1,209,0,30,8,8,0,0,0,0,727,55,672,727,402,325,44,42,12700
42,101,12800,258247,236,165,165,0,165,145,20,236,236,0,0,236,232,197,15,0,13,0,7,4,4,0,0,0,0,236,14,222,236,133,103,197,42,12800
42,101,12900,358427,553,373,373,0,373,329,44,553,553,0,0,553,543,426,75,0,11,0,31,10,10,0,0,0,0,553,58,495,553,320,233,426,42,12900
42,101,13000,207550,994,537,537,0,537,477,60,994,994,0,0,994,969,386,499,3,7,0,74,25,22,1,2,0,0,994,125,869,994,486,508,386,42,13000
42,101,13100,320911,1676,843,843,0,843,688,155,1676,1676,0,0,1676,1643,79,1503,6,10,1,44,33,25,5,3,0,0,1676,78,1598,1676,696,980,79,42,13100
42,101,13200,433616,2158,1198,1198,0,1198,704,494,2158,2158,0,0,2158,2139,118,1929,3,36,2,51,19,19,0,0,0,0,2158,101,2057,2158,1001,1157,118,42,13200
42,101,13300,360277,2249,1248,1248,0,1248,1017,231,2249,2249,0,0,2249,2192,549,1362,14,58,0,209,57,54,3,0,0,0,2249,359,1890,2249,1150,1099,549,42,13300
42,101,13400,424844,5386,3352,3352,0,3352,3062,290,5386,5386,0,0,5386,5263,3973,874,11,120,4,281,123,111,10,2,0,0,5386,549,4837,5386,2593,2793,3973,42,13400
42,101,13500,405925,3437,1491,1491,0,1491,1351,140,3437,3437,0,0,3437,3376,1309,1794,4,39,2,228,61,57,4,0,0,0,3437,344,3093,3437,1595,1842,1309,42,13500
42,101,13600,403252,5962,3497,3497,0,3497,3174,323,5962,5962,0,0,5962,5819,5036,520,6,175,9,73,143,139,4,0,0,0,5962,172,5790,5962,2919,3043,5036,42,13600
42,101,13700,605749,5052,2507,2507,0,2507,1893,614,5052,5052,0,0,5052,4994,286,4661,8,18,0,21,58,55,3,0,0,0,5052,75,4977,5052,2271,2781,286,42,13700
42,101,13800,350601,2339,1208,1208,0,1208,894,314,2339,2339,0,0,2339,2317,59,2237,6,3,0,12,22,20,1,1,0,0,2339,30,2309,2339,1064,1275,59,42,13800
42,101,13900,567290,2716,1345,1345,0,1345,849,496,2716,2716,0,0,2716,2671,206,2398,4,12,1,50,45,42,3,0,0,0,2716,106,2610,2716,1219,1497,206,42,13900
42,101,14000,429220,3011,1697,1697,0,1697,1192,505,3011,3011,0,0,3011,2952,126,2725,5,46,0,50,59,45,12,2,0,0,3011,106,2905,3011,1406,1605,126,42,14000
42,101,14100,571311,2303,1317,1317,0,1317,935,382,2303,2303,0,0,2303,2260,231,1878,8,9,0,134,43,43,0,0,0,0,2303,261,2042,2303,1004,1299,231,42,14100
42,101,14200,795484,2171,1201,1201,0,1201,983,218,2171,2171,0,0,2171,2076,1162,634,5,25,3,247,95,79,14,2,0,0,2171,494,1677,2171,1120,1051,1162,42,14200
42,101,14300,552435,1449,734,734,0,734,624,110,1449,1449,0,0,1449,1408,1301,69,0,13,3,22,41,35,5,1,0,0,1449,66,1383,1449,706,743,1301,42,14300
42,101,14400,619087,3217,1377,1377,0,1377,1152,225,3217,3217,0,0,3217,3032,1224,950,15,46,8,789,185,171,13,1,0,0,3217,1387,1830,3217,1578,1639,1224,42,14400
42,101,14500,324608,1431,702,702,0,702,538,164,1431,1431,0,0,1431,1400,103,1048,1,0,1,247,31,31,0,0,0,0,1431,403,1028,1431,591,840,103,42,14500
42,101,14600,456701,3260,967,967,0,967,920,47,3260,3260,0,0,3260,3218,693,2359,9,112,1,44,42,40,2,0,0,0,3260,103,3157,3260,1342,1918,693,42,14600
42,101,14700,343753,2338,1160,1160,0,1160,755,405,2338,2338,0,0,2338,2319,34,2252,3,16,1,13,19,15,1,3,0,0,2338,41,2297,2338,1075,1263,34,42,14700
42,101,14800,190661,742,598,598,0,598,342,256,742,742,0,0,742,742,8,732,2,0,0,0,0,0,0,0,0,0,742,3,739,742,365,377,8,42,14800
42,101,14900,449613,4634,2253,2253,0,2253,1739,514,4634,4634,0,0,4634,4577,31,4513,11,15,0,7,57,55,2,0,0,0,4634,63,4571,4634,2058,2576,31,42,14900
42,101,15000,2395722,110,58,58,0,58,55,3,110,110,0,0,110,109,38,71,0,0,0,0,1,1,0,0,0,0,110,0,110,110,52,58,38,42,15000
42,101,15100,742467,8018,3878,3878,0,3878,3044,834,8018,8018,0,0,8018,7950,29,7862,25,19,0,15,68,56,10,1,1,0,8018,78,7940,8018,3425,4593,29,42,15100
42,101,15200,658969,5167,2374,2374,0,2374,1602,772,5167,5167,0,0,5167,5118,37,5029,8,12,0,32,49,42,5,2,0,0,5167,89,5078,5167,2256,2911,37,42,15200
42,101,15300,463065,3382,1706,1706,0,1706,1176,530,3382,3382,0,0,3382,3347,263,2976,11,84,2,11,35,34,1,0,0,0,3382,47,3335,3382,1553,1829,263,42,15300
42,101,15400,310278,2258,230,230,0,230,188,42,2258,2258,0,0,2258,2232,811,1167,2,126,7,119,26,23,2,1,0,0,2258,62,2196,2258,939,1319,811,42,15400
42,101,15500,420654,2941,1115,1115,0,1115,852,263,2941,2941,0,0,2941,2885,273,2191,18,13,0,390,56,55,1,0,0,0,2941,725,2216,2941,1284,1657,273,42,15500
42,101,15600,429988,1992,702,702,0,702,588,114,1992,1992,0,0,1992,1877,291,444,6,10,6,1120,115,115,0,0,0,0,1992,1449,543,1992,993,999,291,42,15600
42,101,15700,491690,2732,1037,1037,0,1037,868,169,2732,2732,0,0,2732,2511,1089,276,19,58,5,1064,221,213,8,0,0,0,2732,1585,1147,2732,1309,1423,1089,42,15700
42,101,15800,594738,5854,2575,2575,0,2575,2265,310,5854,5854,0,0,5854,5728,5365,138,13,104,0,108,126,122,4,0,0,0,5854,227,5627,5854,2857,2997,5365,42,15800
42,101,15900,529864,1817,819,819,0,819,686,133,1817,1817,0,0,1817,1797,1746,32,6,2,0,11,20,20,0,0,0,0,1817,53,1764,1817,886,931,1746,42,15900
42,101,16000,718178,7406,3051,3051,0,3051,2661,390,7406,7406,0,0,7406,7205,6881,87,23,90,5,119,201,199,2,0,0,0,7406,295,7111,7406,3592,3814,6881,42,16000
42,101,16100,692921,5548,2253,2253,0,2253,1830,423,5548,5548,0,0,5548,5348,3324,464,37,811,3,709,200,196,4,0,0,0,5548,1268,4280,5548,2817,2731,3324,42,16100
42,101,16200,351050,2329,870,870,0,870,719,151,2329,2329,0,0,2329,2204,516,620,40,26,1,1001,125,109,15,1,0,0,2329,1676,653,2329,1138,1191,516,42,16200
42,101,16300,568344,3629,1294,1294,0,1294,1062,232,3629,3629,0,0,3629,3461,660,614,34,231,8,1914,168,166,2,0,0,0,3629,2664,965,3629,1747,1882,660,42,16300
42,101,16400,480204,5233,1780,1780,0,1780,1538,242,5233,5233,0,0,5233,4978,734,2377,9,15,0,1843,255,231,24,0,0,0,5233,2852,2381,5233,2416,2817,734,42,16400
42,101,16500,400786,2722,1398,1398,0,1398,904,494,2722,2722,0,0,2722,2667,61,2555,7,8,0,36,55,40,15,0,0,0,2722,132,2590,2722,1245,1477,61,42,16500
42,101,16600,254725,1699,842,842,0,842,662,180,1699,1699,0,0,1699,1669,45,1600,5,3,0,16,30,24,3,3,0,0,1699,27,1672,1699,937,762,45,42,16600
42,101,16700,612550,6947,3320,3320,0,3320,2590,730,6947,6947,0,0,6947,6878,45,6740,25,31,0,37,69,64,5,0,0,0,6947,106,6841,6947,3079,3868,45,42,16700
42,101,16800,579229,4553,2040,2040,0,2040,1687,353,4553,4553,0,0,4553,4477,23,4402,15,18,2,17,76,60,15,1,0,0,4553,61,4492,4553,1963,2590,23,42,16800
42,101,16901,513979,3892,1835,1835,0,1835,1493,342,3892,3892,0,0,3892,3851,29,3792,15,7,2,6,41,40,1,0,0,0,3892,38,3854,3892,1692,2200,29,42,16901
42,101,16902,562208,6492,3059,3059,0,3059,2441,618,6492,6492,0,0,6492,6415,31,6354,6,11,1,12,77,72,5,0,0,0,6492,51,6441,6492,2839,3653,31,42,16902
42,101,17000,1588988,2840,1411,1411,0,1411,1081,330,2840,2840,0,0,2840,2814,300,2488,9,5,1,11,26,25,0,1,0,0,2840,43,2797,2840,1255,1585,300,42,17000
42,101,17100,1150182,4435,1824,1824,0,1824,1671,153,4435,4435,0,0,4435,4395,35,4312,11,8,0,29,40,35,5,0,0,0,4435,51,4384,4435,1897,2538,35,42,17100
42,101,17200,560531,8643,3650,3650,0,3650,3161,489,8643,8643,0,0,8643,8591,44,8468,14,26,0,39,52,50,2,0,0,0,8643,106,8537,8643,3707,4936,44,42,17200
42,101,17300,875674,3152,1427,1427,0,1427,1210,217,3152,3152,0,0,3152,3125,28,3051,5,12,1,28,27,27,0,0,0,0,3152,50,3102,3152,1377,1775,28,42,17300
42,101,17400,347597,2641,1175,1175,0,1175,867,308,2641,2641,0,0,2641,2613,15,2506,5,8,1,78,28,25,3,0,0,0,2641,90,2551,2641,1144,1497,15,42,17400
42,101,17500,719720,7452,2736,2736,0,2736,2229,507,7452,7452,0,0,7452,7167,1404,2659,59,38,13,2994,285,277,7,1,0,0,7452,4934,2518,7452,3465,3987,1404,42,17500
42,101,17601,589704,5863,2240,2240,0,2240,1783,457,5863,5863,0,0,5863,5546,1290,675,63,26,2,3490,317,313,4,0,0,0,5863,5188,675,5863,2799,3064,1290,42,17601
42,101,17602,394381,3867,1406,1406,0,1406,1118,288,3867,3867,0,0,3867,3672,978,609,30,49,5,2001,195,184,11,0,0,0,3867,2999,868,3867,1834,2033,978,42,17602
42,101,17700,714810,9159,3355,3355,0,3355,2677,678,9159,9159,0,0,9159,8810,2811,2343,71,336,13,3236,349,336,10,1,2,0,9159,5047,4112,9159,4261,4898,2811,42,17700
42,101,17800,660699,6340,2642,2642,0,2642,2100,542,6340,6340,0,0,6340,6088,3239,1347,41,224,3,1234,252,248,4,0,0,0,6340,2099,4241,6340,3125,3215,3239,42,17800
42,101,17900,695087,6050,2503,2503,0,2503,2108,395,6050,6050,0,0,6050,5853,4350,841,16,58,3,585,197,186,9,2,0,0,6050,929,5121,6050,2802,3248,4350,42,17900
42,101,18000,819245,8005,3753,3753,0,3753,3408,345,8005,8005,0,0,8005,7835,7720,22,15,34,4,40,170,168,0,1,0,1,8005,111,7894,8005,3813,4192,7720,42,18000
42,101,18100,857621,215,117,117,0,117,99,18,215,215,0,0,215,209,195,12,0,0,0,2,6,6,0,0,0,0,215,5,210,215,118,97,195,42,18100
42,101,18200,2350963,393,180,180,0,180,161,19,393,393,0,0,393,380,360,6,0,3,0,11,13,13,0,0,0,0,393,17,376,393,204,189,360,42,18200
42,101,18300,1886012,4008,1707,1707,0,1707,1612,95,4008,4008,0,0,4008,3970,3911,11,16,6,1,25,38,38,0,0,0,0,4008,42,3966,4008,1883,2125,3911,42,18300
42,101,18400,1359010,2178,886,886,0,886,834,52,2178,2178,0,0,2178,2150,2108,2,9,10,0,21,28,28,0,0,0,0,2178,49,2129,2178,1042,1136,2108,42,18400
42,101,18500,660842,123,67,67,0,67,59,8,123,123,0,0,123,121,114,2,0,3,0,2,2,2,0,0,0,0,123,4,119,123,63,60,114,42,18500
42,101,18600,712423,4892,2185,2185,0,2185,2061,124,4892,4892,0,0,4892,4762,4705,13,2,13,9,20,130,130,0,0,0,0,4892,64,4828,4892,2304,2588,4705,42,18600
42,101,18700,805202,1576,688,688,0,688,608,80,1576,1576,0,0,1576,1546,1368,92,7,18,0,61,30,29,1,0,0,0,1576,118,1458,1576,748,828,1368,42,18700
42,101,18800,668216,7257,2911,2911,0,2911,2506,405,7257,7257,0,0,7257,7048,4947,903,22,111,8,1057,209,205,4,0,0,0,7257,1583,5674,7257,3510,3747,4947,42,18800
42,101,18900,1022195,1003,378,378,0,378,326,52,1003,1003,0,0,1003,964,619,170,3,29,0,143,39,36,3,0,0,0,1003,249,754,1003,486,517,619,42,18900
42,101,19000,779798,6869,2448,2448,0,2448,2242,206,6869,6869,0,0,6869,6662,4034,958,31,294,12,1333,207,204,2,1,0,0,6869,2208,4661,6869,3223,3646,4034,42,19000
42,101,19100,1468720,6662,2783,2783,0,2783,2605,178,6662,6662,0,0,6662,6398,4257,460,22,380,2,1277,264,252,12,0,0,0,6662,1964,4698,6662,3113,3549,4257,42,19100
42,101,19200,656129,7519,2721,2721,0,2721,2262,459,7519,7519,0,0,7519,7171,2984,1626,50,325,1,2185,348,345,3,0,0,0,7519,3607,3912,7519,3480,4039,2984,42,19200
42,101,19300,927257,111,42,42,0,42,38,4,111,111,0,0,111,102,56,10,0,2,0,34,9,9,0,0,0,0,111,48,63,111,52,59,56,42,19300
42,101,19400,1345798,340,119,119,0,119,105,14,340,340,0,0,340,303,107,72,5,24,1,94,37,33,4,0,0,0,340,174,166,340,164,176,107,42,19400
42,101,19500,788873,8642,3019,3019,0,3019,2577,442,8642,8642,0,0,8642,8233,2411,1183,65,97,4,4473,409,390,18,1,0,0,8642,6841,1801,8642,4052,4590,2411,42,19500
42,101,19600,750372,2677,918,918,0,918,831,87,2677,2677,0,0,2677,2581,832,640,30,15,1,1063,96,96,0,0,0,0,2677,1870,807,2677,1242,1435,832,42,19600
42,101,19700,855534,7139,2307,2307,0,2307,2067,240,7139,7139,0,0,7139,6819,1313,2776,40,73,1,2616,320,275,40,5,0,0,7139,4186,2953,7139,3372,3767,1313,42,19700
42,101,19800,541688,6239,2109,2109,0,2109,1850,259,6239,6239,0,0,6239,5922,863,2529,57,174,13,2286,317,249,22,46,0,0,6239,3444,2795,6239,2934,3305,863,42,19800
42,101,19900,664919,4897,1701,1701,0,1701,1444,257,4897,4897,0,0,4897,4741,713,2282,35,28,16,1667,156,154,2,0,0,0,4897,2524,2373,4897,2291,2606,713,42,19900
42,101,20000,319461,1861,783,783,0,783,629,154,1861,1861,0,0,1861,1840,307,1320,6,130,0,77,21,16,5,0,0,0,1861,95,1766,1861,874,987,307,42,20000
42,101,20100,871226,7732,3843,3843,0,3843,3120,723,7732,7732,0,0,7732,7629,80,7425,20,23,2,79,103,94,9,0,0,0,7732,169,7563,7732,3497,4235,80,42,20100
42,101,20200,763558,5666,2661,2661,0,2661,2174,487,5666,5666,0,0,5666,5602,140,5391,17,10,1,43,64,55,9,0,0,0,5666,78,5588,5666,2558,3108,140,42,20200
42,101,20300,524368,3140,1461,1461,0,1461,1081,380,3140,3140,0,0,3140,3085,118,2831,21,30,0,85,55,45,10,0,0,0,3140,148,2992,3140,1435,1705,118,42,20300
42,101,20400,412223,3398,1395,1395,0,1395,1184,211,3398,3398,0,0,3398,3354,79,3235,3,8,0,29,44,38,6,0,0,0,3398,64,3334,3398,1535,1863,79,42,20400
42,101,20500,1431411,3139,1490,1490,0,1490,1296,194,3139,3139,0,0,3139,3090,181,2765,7,91,0,46,49,49,0,0,0,0,3139,72,3067,3139,1340,1799,181,42,20500
42,101,20600,1285681,1815,1036,1036,0,1036,977,59,1815,1815,0,0,1815,1774,1100,501,2,144,0,27,41,36,4,1,0,0,1815,56,1759,1815,791,1024,1100,42,20600
42,101,20700,1429929,6378,2674,2674,0,2674,2369,305,6378,6378,0,0,6378,6266,5042,972,25,191,3,33,112,105,7,0,0,0,6378,146,6232,6378,2951,3427,5042,42,20700
42,101,20800,896401,1906,1260,1260,0,1260,1207,53,1906,1906,0,0,1906,1855,1145,536,1,147,0,26,51,38,13,0,0,0,1906,62,1844,1906,866,1040,1145,42,20800
42,101,20900,530703,2835,1365,1365,0,1365,1300,65,2835,2835,0,0,2835,2799,2695,57,4,29,0,14,36,32,3,1,0,0,2835,41,2794,2835,1399,1436,2695,42,20900
42,101,21000,850881,4994,2244,2244,0,2244,2131,113,4994,4994,0,0,4994,4937,4630,228,9,48,2,20,57,56,1,0,0,0,4994,63,4931,4994,2391,2603,4630,42,21000
42,101,21100,547341,2587,1226,1226,0,1226,1160,66,2587,2587,0,0,2587,2561,2302,209,0,38,0,12,26,25,1,0,0,0,2587,52,2535,2587,1211,1376,2302,42,21100
42,101,21200,496204,2401,1116,1116,0,1116,1070,46,2401,2401,0,0,2401,2374,2179,125,6,45,1,18,27,26,1,0,0,0,2401,53,2348,2401,1130,1271,2179,42,21200
42,101,21300,543516,3676,1613,1613,0,1613,1527,86,3676,3676,0,0,3676,3633,3331,240,7,34,0,21,43,43,0,0,0,0,3676,61,3615,3676,1780,1896,3331,42,21300
42,101,21400,634669,3970,1970,1970,0,1970,1824,146,3970,3970,0,0,3970,3909,3426,397,16,55,0,15,61,55,6,0,0,0,3970,57,3913,3970,1998,1972,3426,42,21400
42,101,21500,997612,3541,1646,1646,0,1646,1524,122,3541,3541,0,0,3541,3503,3297,119,7,65,1,14,38,37,1,0,0,0,3541,46,3495,3541,1731,1810,3297,42,21500
42,101,21600,2065693,1780,892,892,0,892,850,42,1780,1780,0,0,1780,1754,1531,189,3,21,0,10,26,26,0,0,0,0,1780,30,1750,1780,822,958,1531,42,21600
42,101,21700,1573304,5968,2544,2544,0,2544,2471,73,5968,5968,0,0,5968,5888,5341,356,13,154,0,24,80,77,3,0,0,0,5968,102,5866,5968,2808,3160,5341,42,21700
42,101,21800,1015446,4490,2374,2374,0,2374,2317,57,4490,4490,0,0,4490,4388,3636,352,4,351,1,44,102,93,7,2,0,0,4490,143,4347,4490,2088,2402,3636,42,21800
42,101,21900,1319379,1169,543,543,0,543,518,25,1169,1169,0,0,1169,1149,1067,61,0,19,1,1,20,14,5,1,0,0,1169,22,1147,1169,537,632,1067,42,21900
42,101,22000,2916680,1603,733,733,0,733,690,43,1603,1603,0,0,1603,1592,1473,78,2,31,2,6,11,11,0,0,0,0,1603,18,1585,1603,624,979,1473,42,22000
42,101,22100,656600,1108,471,471,0,471,462,9,1108,1108,0,0,1108,1095,1038,33,1,23,0,0,13,13,0,0,0,0,1108,26,1082,1108,469,639,1038,42,22100
42,101,22200,1943506,1446,518,518,0,518,510,8,1446,1446,0,0,1446,1429,1270,100,1,50,1,7,17,10,7,0,0,0,1446,22,1424,1446,712,734,1270,42,22200
42,101,22300,5653647,202,90,90,0,90,87,3,202,202,0,0,202,198,133,57,1,2,0,5,4,4,0,0,0,0,202,8,194,202,95,107,133,42,22300
42,101,22400,649022,384,126,126,0,126,124,2,384,384,0,0,384,381,320,55,0,5,0,1,3,3,0,0,0,0,384,12,372,384,201,183,320,42,22400
42,101,22500,896447,571,80,80,0,80,80,0,571,571,0,0,571,562,460,67,0,10,1,24,9,8,0,1,0,0,571,37,534,571,101,470,460,42,22500
42,101,22600,616550,475,102,102,0,102,96,6,475,475,0,0,475,474,402,64,3,2,0,3,1,1,0,0,0,0,475,13,462,475,182,293,402,42,22600
42,101,22700,573772,1231,576,576,0,576,559,17,1231,1231,0,0,1231,1219,1134,55,3,23,0,4,12,12,0,0,0,0,1231,16,1215,1231,536,695,1134,42,22700
42,101,22800,704419,1520,833,833,0,833,802,31,1520,1520,0,0,1520,1499,1431,28,0,30,0,10,21,21,0,0,0,0,1520,25,1495,1520,644,876,1431,42,22800
42,101,22900,1198678,301,114,114,0,114,107,7,301,301,0,0,301,297,278,8,0,11,0,0,4,4,0,0,0,0,301,0,301,301,143,158,278,42,22900
42,101,23000,1247846,438,247,247,0,247,240,7,438,438,0,0,438,431,401,22,1,3,0,4,7,7,0,0,0,0,438,5,433,438,195,243,401,42,23000
42,101,23100,849906,1242,551,551,0,551,528,23,1242,1242,0,0,1242,1222,1170,25,0,22,0,5,20,15,0,0,5,0,1242,15,1227,1242,584,658,1170,42,23100
42,101,23200,783267,649,343,343,0,343,320,23,649,649,0,0,649,638,449,178,0,5,0,6,11,11,0,0,0,0,649,6,643,649,268,381,449,42,23200
42,101,23300,595877,3097,1484,1484,0,1484,1397,87,3097,3097,0,0,3097,3011,1495,1375,6,73,6,56,86,61,22,3,0,0,3097,74,3023,3097,1342,1755,1495,42,23300
42,101,23400,809228,547,217,217,0,217,214,3,547,547,0,0,547,539,395,127,0,8,0,9,8,8,0,0,0,0,547,8,539,547,256,291,395,42,23400
42,101,23500,794652,1141,521,521,0,521,487,34,1141,1141,0,0,1141,1129,707,394,0,17,0,11,12,11,1,0,0,0,1141,14,1127,1141,509,632,707,42,23500
42,101,23600,978272,2659,1167,1167,0,1167,1117,50,2659,2659,0,0,2659,2580,1485,1033,3,29,0,30,79,69,10,0,0,0,2659,50,2609,2659,1139,1520,1485,42,23600
42,101,23700,1082214,5123,2358,2358,0,2358,2139,219,5123,5123,0,0,5123,4943,1331,3479,21,44,7,61,180,151,29,0,0,0,5123,128,4995,5123,2150,2973,1331,42,23700
42,101,23800,788265,4896,2433,2433,0,2433,2197,236,4896,4896,0,0,4896,4748,1081,3595,11,31,4,26,148,126,18,3,0,1,4896,73,4823,4896,2164,2732,1081,42,23800
42,101,23900,489106,2015,1327,1327,0,1327,1258,69,2015,2015,0,0,2015,1967,624,1220,5,94,2,22,48,44,3,1,0,0,2015,50,1965,2015,900,1115,624,42,23900
42,101,24000,618282,4208,2201,2201,0,2201,1926,275,4208,4208,0,0,4208,4108,911,3072,11,72,2,40,100,81,19,0,0,0,4208,91,4117,4208,1941,2267,911,42,24000
42,101,24100,409706,1436,769,769,0,769,683,86,1436,1436,0,0,1436,1410,195,1181,7,16,0,11,26,23,3,0,0,0,1436,12,1424,1436,646,790,195,42,24100
42,101,24200,533953,4172,1974,1974,0,1974,1720,254,4172,4172,0,0,4172,4071,464,3519,9,22,3,54,101,93,7,1,0,0,4172,86,4086,4172,1880,2292,464,42,24200
42,101,24300,675671,4016,1888,1888,0,1888,1622,266,4016,4016,0,0,4016,3914,345,3499,7,36,0,27,102,94,6,2,0,0,4016,70,3946,4016,1827,2189,345,42,24300
42,101,24400,422067,3491,1372,1372,0,1372,1151,221,3491,3491,0,0,3491,3424,195,3174,16,5,1,33,67,63,2,1,1,0,3491,73,3418,3491,1645,1846,195,42,24400
42,101,24500,802597,4510,1824,1824,0,1824,1543,281,4510,4510,0,0,4510,4421,223,4141,13,7,4,33,89,77,12,0,0,0,4510,88,4422,4510,1936,2574,223,42,24500
42,101,24600,622346,2883,1357,1357,0,1357,1140,217,2883,2883,0,0,2883,2831,143,2652,13,3,1,19,52,43,9,0,0,0,2883,33,2850,2883,1274,1609,143,42,24600
42,101,24700,940563,4866,2083,2083,0,2083,1681,402,4866,4866,0,0,4866,4769,313,4398,17,26,0,15,97,84,13,0,0,0,4866,59,4807,4866,2242,2624,313,42,24700
42,101,24800,325186,2137,807,807,0,807,706,101,2137,2137,0,0,2137,2098,35,2030,6,14,0,13,39,34,5,0,0,0,2137,17,2120,2137,978,1159,35,42,24800
42,101,24900,326025,3619,1393,1393,0,1393,1235,158,3619,3619,0,0,3619,3570,51,3501,8,6,0,4,49,41,7,1,0,0,3619,31,3588,3619,1591,2028,51,42,24900
42,101,25000,752319,1120,326,326,0,326,302,24,1120,1120,0,0,1120,1098,100,973,2,7,5,11,22,17,1,4,0,0,1120,21,1099,1120,483,637,100,42,25000
42,101,25100,527721,2133,977,977,0,977,902,75,2133,2133,0,0,2133,2087,45,2008,15,8,0,11,46,37,9,0,0,0,2133,29,2104,2133,954,1179,45,42,25100
42,101,25200,944427,7327,3107,3107,0,3107,2736,371,7327,7327,0,0,7327,7197,448,6641,28,25,0,55,130,124,6,0,0,0,7327,95,7232,7327,3196,4131,448,42,25200
42,101,25300,571803,4284,1901,1901,0,1901,1693,208,4284,4284,0,0,4284,4182,125,4013,8,8,8,20,102,80,13,9,0,0,4284,71,4213,4284,1915,2369,125,42,25300
42,101,25400,772727,4303,2023,2023,0,2023,1933,90,4303,4303,0,0,4303,4209,222,3923,20,16,0,28,94,83,9,2,0,0,4303,69,4234,4303,1868,2435,222,42,25400
42,101,25500,777730,2762,1152,1152,0,1152,1087,65,2762,2762,0,0,2762,2683,630,2015,15,11,4,8,79,57,22,0,0,0,2762,43,2719,2762,1252,1510,630,42,25500
42,101,25600,868771,2975,1190,1190,0,1190,1146,44,2975,2975,0,0,2975,2895,1368,1440,3,52,2,30,80,70,10,0,0,0,2975,67,2908,2975,1335,1640,1368,42,25600
42,101,25700,743665,3320,1896,1896,0,1896,1728,168,3320,3320,0,0,3320,3230,1911,1148,12,118,4,37,90,74,13,3,0,0,3320,93,3227,3320,1383,1937,1911,42,25700
42,101,25800,583601,1707,772,772,0,772,757,15,1707,1707,0,0,1707,1676,71,1597,3,2,0,3,31,26,5,0,0,0,1707,15,1692,1707,752,955,71,42,25800
42,101,25900,546218,5174,2125,2125,0,2125,2049,76,5174,5174,0,0,5174,5102,124,4942,12,15,1,8,72,61,10,1,0,0,5174,62,5112,5174,2303,2871,124,42,25900
42,101,26000,539180,3050,1255,1255,0,1255,1208,47,3050,3050,0,0,3050,2980,63,2907,5,5,0,0,70,64,6,0,0,0,3050,32,3018,3050,1327,1723,63,42,26000
42,101,26100,664513,3237,1460,1460,0,1460,1409,51,3237,3237,0,0,3237,3171,85,3063,5,9,1,8,66,59,6,1,0,0,3237,28,3209,3237,1412,1825,85,42,26100
42,101,26200,554858,4564,1833,1833,0,1833,1781,52,4564,4564,0,0,4564,4483,57,4404,9,6,0,7,81,63,17,1,0,0,4564,49,4515,4564,1981,2583,57,42,26200
42,101,26301,411356,4313,1628,1628,0,1628,1562,66,4313,4313,0,0,4313,4241,112,4090,17,5,0,17,72,61,11,0,0,0,4313,45,4268,4313,1886,2427,112,42,26301
42,101,26302,694528,5754,2168,2168,0,2168,2048,120,5754,5754,0,0,5754,5625,82,5487,13,31,3,9,129,115,14,0,0,0,5754,53,5701,5754,2568,3186,82,42,26302
42,101,26400,795447,5943,2281,2281,0,2281,2187,94,5943,5943,0,0,5943,5825,77,5682,19,12,6,29,118,109,9,0,0,0,5943,92,5851,5943,2592,3351,77,42,26400
42,101,26500,549955,4823,1885,1885,0,1885,1744,141,4823,4823,0,0,4823,4747,80,4616,18,11,4,18,76,71,5,0,0,0,4823,50,4773,4823,2116,2707,80,42,26500
42,101,26600,899183,6975,2645,2645,0,2645,2511,134,6975,6975,0,0,6975,6821,71,6702,16,9,0,23,154,138,16,0,0,0,6975,67,6908,6975,3088,3887,71,42,26600
42,101,26700,643341,7068,2743,2743,0,2743,2546,197,7068,7068,0,0,7068,6968,99,6817,16,25,0,11,100,82,12,6,0,0,7068,51,7017,7068,3177,3891,99,42,26700
42,101,26800,766940,4698,2060,2060,0,2060,1839,221,4698,4698,0,0,4698,4573,363,4080,16,77,3,34,125,116,8,0,1,0,4698,70,4628,4698,2106,2592,363,42,26800
42,101,26900,622909,2359,773,773,0,773,723,50,2359,2359,0,0,2359,2285,719,1318,8,174,1,65,74,63,8,3,0,0,2359,114,2245,2359,1083,1276,719,42,26900
42,101,27000,644183,2452,980,980,0,980,933,47,2452,2452,0,0,2452,2406,535,1696,1,121,0,53,46,38,7,1,0,0,2452,106,2346,2452,1126,1326,535,42,27000
42,101,27100,375764,2438,950,950,0,950,917,33,2438,2438,0,0,2438,2362,541,1142,6,517,0,156,76,75,1,0,0,0,2438,246,2192,2438,1143,1295,541,42,27100
42,101,27200,662079,4567,1925,1925,0,1925,1829,96,4567,4567,0,0,4567,4447,687,3245,6,361,0,148,120,112,7,1,0,0,4567,299,4268,4567,2047,2520,687,42,27200
42,101,27300,958933,6000,2146,2146,0,2146,2038,108,6000,6000,0,0,6000,5755,1355,2614,14,1310,9,453,245,235,8,2,0,0,6000,919,5081,6000,2827,3173,1355,42,27300
42,101,27400,822871,10479,3611,3611,0,3611,3327,284,10479,10479,0,0,10479,9974,2388,4490,35,2113,5,943,505,477,19,9,0,0,10479,1840,8639,10479,4959,5520,2388,42,27400
42,101,27500,614546,4823,1685,1685,0,1685,1572,113,4823,4823,0,0,4823,4633,955,2740,14,664,0,260,190,182,8,0,0,0,4823,519,4304,4823,2272,2551,955,42,27500
42,101,27600,663499,3932,1781,1781,0,1781,1532,249,3932,3932,0,0,3932,3835,152,3622,12,23,5,21,97,91,6,0,0,0,3932,66,3866,3932,1815,2117,152,42,27600
42,101,27700,551000,5102,2213,2213,0,2213,2054,159,5102,5102,0,0,5102,5040,87,4838,14,83,1,17,62,52,10,0,0,0,5102,88,5014,5102,2165,2937,87,42,27700
42,101,27800,731851,4867,2270,2270,0,2270,2034,236,4867,4867,0,0,4867,4790,88,4638,8,22,0,34,77,73,4,0,0,0,4867,94,4773,4867,2215,2652,88,42,27800
42,101,27900,1295913,8350,2792,2792,0,2792,2497,295,8350,8350,0,0,8350,8211,1915,6161,16,72,0,47,139,112,27,0,0,0,8350,152,8198,8350,3730,4620,1915,42,27900
42,101,28000,713305,4819,1864,1864,0,1864,1715,149,4819,4819,0,0,4819,4765,61,4661,16,13,0,14,54,51,3,0,0,0,4819,59,4760,4819,2141,2678,61,42,28000
42,101,28100,508891,4012,1465,1465,0,1465,1302,163,4012,4012,0,0,4012,3951,186,3593,14,120,2,36,61,60,0,1,0,0,4012,106,3906,4012,1801,2211,186,42,28100
42,101,28200,860951,5448,2211,2211,0,2211,1650,561,5448,5448,0,0,5448,5346,777,4173,9,293,1,93,102,90,12,0,0,0,5448,185,5263,5448,2354,3094,777,42,28200
42,101,28300,677857,7270,2861,2861,0,2861,2426,435,7270,7270,0,0,7270,7072,210,5947,28,729,3,155,198,189,9,0,0,0,7270,266,7004,7270,3373,3897,210,42,28300
42,101,28400,477902,4409,1507,1507,0,1507,1336,171,4409,4409,0,0,4409,4285,335,3443,10,75,2,420,124,114,10,0,0,0,4409,739,3670,4409,2020,2389,335,42,28400
42,101,28500,283162,2373,884,884,0,884,770,114,2373,2373,0,0,2373,2276,310,1172,5,391,5,393,97,94,3,0,0,0,2373,678,1695,2373,1079,1294,310,42,28500
42,101,28600,684107,7337,2411,2411,0,2411,2169,242,7337,7337,0,0,7337,7049,1351,3414,30,881,5,1368,288,281,3,4,0,0,7337,2318,5019,7337,3417,3920,1351,42,28600
42,101,28700,350818,2489,846,846,0,846,776,70,2489,2489,0,0,2489,2390,638,778,6,30,1,937,99,89,10,0,0,0,2489,1533,956,2489,1199,1290,638,42,28700
42,101,28800,455181,4373,1457,1457,0,1457,1315,142,4373,4373,0,0,4373,3955,1112,911,22,504,12,1394,418,413,3,2,0,0,4373,2087,2286,4373,2105,2268,1112,42,28800
42,101,28900,1388121,10116,3259,3259,0,3259,3003,256,10116,10116,0,0,10116,9360,2745,2677,55,1016,2,2865,756,739,17,0,0,0,10116,4401,5715,10116,4892,5224,2745,42,28900
42,101,29000,803308,6217,2123,2123,0,2123,1982,141,6217,6217,0,0,6217,5956,1504,2179,34,1308,1,930,261,256,5,0,0,0,6217,1559,4658,6217,2955,3262,1504,42,29000
42,101,29100,1355978,4371,1645,1645,0,1645,1470,175,4371,4371,0,0,4371,4195,1256,1416,15,1166,0,342,176,170,6,0,0,0,4371,639,3732,4371,2088,2283,1256,42,29100
42,101,29200,1715396,4295,1425,1425,0,1425,1325,100,4295,4295,0,0,4295,3978,1744,1211,17,416,9,581,317,313,3,1,0,0,4295,1149,3146,4295,2070,2225,1744,42,29200
42,101,29300,691757,3005,1222,1222,0,1222,1051,171,3005,3005,0,0,3005,2886,1876,690,19,51,3,247,119,109,10,0,0,0,3005,559,2446,3005,1445,1560,1876,42,29300
42,101,29400,665592,3125,1296,1296,0,1296,1054,242,3125,3125,0,0,3125,3002,1231,1323,7,33,5,403,123,111,12,0,0,0,3125,675,2450,3125,1505,1620,1231,42,29400
42,101,29500,635012,1031,440,440,0,440,400,40,1031,1031,0,0,1031,1024,996,9,0,6,0,13,7,6,1,0,0,0,1031,39,992,1031,481,550,996,42,29500
42,101,29600,236516,1176,508,508,0,508,448,60,1176,1176,0,0,1176,1160,1056,46,14,11,0,33,16,16,0,0,0,0,1176,105,1071,1176,570,606,1056,42,29600
42,101,29700,735917,437,182,182,0,182,165,17,437,437,0,0,437,418,384,24,2,4,0,4,19,19,0,0,0,0,437,20,417,437,220,217,384,42,29700
42,101,29800,649094,4395,1931,1931,0,1931,1796,135,4395,4395,0,0,4395,4285,3526,443,11,36,8,261,110,105,5,0,0,0,4395,376,4019,4395,2082,2313,3526,42,29800
42,101,29900,598853,4448,1735,1735,0,1735,1554,181,4448,4448,0,0,4448,4330,2015,1776,9,57,0,473,118,116,2,0,0,0,4448,742,3706,4448,1991,2457,2015,42,29900
42,101,30000,911391,7150,2978,2978,0,2978,2527,451,7150,7150,0,0,7150,6917,2428,3822,30,159,5,473,233,226,7,0,0,0,7150,737,6413,7150,3322,3828,2428,42,30000
42,101,30100,727289,6050,2484,2484,0,2484,2201,283,6050,6050,0,0,6050,5826,3112,2191,12,121,1,389,224,211,10,3,0,0,6050,775,5275,6050,2926,3124,3112,42,30100
42,101,30200,895435,6694,2609,2609,0,2609,2417,192,6694,6694,0,0,6694,6531,4619,1223,16,236,2,435,163,161,2,0,0,0,6694,785,5909,6694,3246,3448,4619,42,30200
42,101,30300,756931,6887,2631,2631,0,2631,2438,193,6887,6887,0,0,6887,6699,4028,1843,14,216,4,594,188,182,6,0,0,0,6887,1056,5831,6887,3242,3645,4028,42,30300
42,101,30400,1323413,495,224,224,0,224,190,34,495,495,0,0,495,467,312,103,2,9,0,41,28,28,0,0,0,0,495,101,394,495,239,256,312,42,30400
42,101,30500,1073883,10172,3988,3988,0,3988,3786,202,10172,10172,0,0,10172,9941,6782,2041,21,425,1,671,231,218,9,1,3,0,10172,1431,8741,10172,4745,5427,6782,42,30500
42,101,30600,999709,6911,2856,2856,0,2856,2703,153,6911,6911,0,0,6911,6781,5931,442,4,181,4,219,130,125,4,0,1,0,6911,417,6494,6911,3096,3815,5931,42,30600
42,101,30700,642278,3114,1454,1454,0,1454,1366,88,3114,3114,0,0,3114,3062,2649,196,7,124,0,86,52,48,4,0,0,0,3114,191,2923,3114,1438,1676,2649,42,30700
42,101,30800,790033,4440,1768,1768,0,1768,1713,55,4440,4440,0,0,4440,4375,3863,167,9,219,0,117,65,65,0,0,0,0,4440,198,4242,4440,2084,2356,3863,42,30800
42,101,30900,641103,3529,1440,1440,0,1440,1385,55,3529,3529,0,0,3529,3398,2269,410,14,382,0,323,131,127,4,0,0,0,3529,514,3015,3529,1692,1837,2269,42,30900
42,101,31000,1080206,5888,2280,2280,0,2280,2201,79,5888,5888,0,0,5888,5777,4748,334,11,468,0,216,111,103,8,0,0,0,5888,460,5428,5888,2846,3042,4748,42,31000
42,101,31100,746030,8395,3178,3178,0,3178,2983,195,8395,8395,0,0,8395,8103,5794,1045,37,663,15,549,292,267,23,2,0,0,8395,1061,7334,8395,4005,4390,5794,42,31100
42,101,31200,412627,4171,1677,1677,0,1677,1578,99,4171,4171,0,0,4171,4020,2644,619,2,426,6,323,151,146,4,1,0,0,4171,623,3548,4171,1958,2213,2644,42,31200
42,101,31300,719983,5866,2358,2358,0,2358,2242,116,5866,5866,0,0,5866,5679,4092,472,11,814,0,290,187,181,6,0,0,0,5866,564,5302,5866,2812,3054,4092,42,31300
42,101,31400,1134352,10298,4119,4119,0,4119,3937,182,10298,10298,0,0,10298,10018,8090,563,5,900,2,458,280,272,8,0,0,0,10298,960,9338,10298,4840,5458,8090,42,31400
42,101,31500,1186344,9455,4048,4048,0,4048,3863,185,9455,9455,0,0,9455,9393,9051,121,5,118,8,90,62,62,0,0,0,0,9455,239,9216,9455,4451,5004,9051,42,31500
42,101,31600,730518,5452,2270,2270,0,2270,2174,96,5452,5452,0,0,5452,5380,5226,61,6,33,0,54,72,70,2,0,0,0,5452,136,5316,5452,2492,2960,5226,42,31600
42,101,31700,875649,5470,2355,2355,0,2355,2247,108,5470,5470,0,0,5470,5408,4919,243,13,96,0,137,62,62,0,0,0,0,5470,267,5203,5470,2514,2956,4919,42,31700
42,101,31800,476779,3512,1509,1509,0,1509,1434,75,3512,3512,0,0,3512,3448,2739,416,9,88,0,196,64,63,1,0,0,0,3512,324,3188,3512,1662,1850,2739,42,31800
42,101,31900,767907,4618,1857,1857,0,1857,1751,106,4618,4618,0,0,4618,4547,4253,163,1,24,0,106,71,68,3,0,0,0,4618,273,4345,4618,2228,2390,4253,42,31900
42,101,32000,691619,6199,2635,2635,0,2635,2530,105,6199,6199,0,0,6199,6127,5856,102,2,52,6,109,72,71,1,0,0,0,6199,211,5988,6199,2967,3232,5856,42,32000
42,101,32100,552230,3741,1579,1579,0,1579,1407,172,3741,3741,0,0,3741,3664,3365,184,9,32,0,74,77,68,9,0,0,0,3741,152,3589,3741,1832,1909,3365,42,32100
42,101,32200,534762,197,71,71,0,71,58,13,197,197,0,0,197,195,145,36,6,2,0,6,2,2,0,0,0,0,197,21,176,197,100,97,145,42,32200
42,101,32300,606992,3596,1555,1555,0,1555,1457,98,3596,3596,0,0,3596,3538,3268,151,15,37,1,66,58,56,2,0,0,0,3596,144,3452,3596,1695,1901,3268,42,32300
42,101,32400,679439,18,10,10,0,10,5,5,18,18,0,0,18,18,18,0,0,0,0,0,0,0,0,0,0,0,18,0,18,18,8,10,18,42,32400
42,101,32500,836355,5285,2434,2434,0,2434,2192,242,5285,5285,0,0,5285,5222,4953,128,7,52,1,81,63,53,9,1,0,0,5285,165,5120,5285,2528,2757,4953,42,32500
42,101,32600,807103,6561,2706,2706,0,2706,2570,136,6561,6561,0,0,6561,6481,6169,174,5,73,1,59,80,76,4,0,0,0,6561,180,6381,6561,3129,3432,6169,42,32600
42,101,32700,1378432,494,74,74,0,74,66,8,494,494,0,0,494,480,187,270,3,6,2,12,14,10,4,0,0,0,494,24,470,494,291,203,187,42,32700
42,101,32800,2679847,6206,1,1,0,1,1,0,6206,6206,0,0,6206,6178,916,4533,2,36,4,687,28,28,0,0,0,0,6206,769,5437,6206,5616,590,916,42,32800
42,101,32900,940623,4073,1825,1825,0,1825,1685,140,4073,4073,0,0,4073,3994,3325,574,7,37,3,48,79,75,4,0,0,0,4073,198,3875,4073,1917,2156,3325,42,32900
42,101,33000,739982,7169,2878,2878,0,2878,2726,152,7169,7169,0,0,7169,7096,6731,188,18,66,3,90,73,68,5,0,0,0,7169,253,6916,7169,3405,3764,6731,42,33000
42,101,33100,1191824,8896,3864,3864,0,3864,3660,204,8896,8896,0,0,8896,8801,8464,162,17,103,0,55,95,93,2,0,0,0,8896,207,8689,8896,4156,4740,8464,42,33100
42,101,33200,837386,2542,1034,1034,0,1034,995,39,2542,2542,0,0,2542,2523,2438,43,6,27,0,9,19,19,0,0,0,0,2542,53,2489,2542,1186,1356,2438,42,33200
42,101,33300,1045351,4272,1836,1836,0,1836,1768,68,4272,4272,0,0,4272,4207,3744,277,5,123,0,58,65,62,3,0,0,0,4272,145,4127,4272,1742,2530,3744,42,33300
42,101,33400,1177869,4795,2113,2113,0,2113,2033,80,4795,4795,0,0,4795,4688,3925,328,12,316,0,107,107,102,4,1,0,0,4795,312,4483,4795,2144,2651,3925,42,33400
42,101,33500,919831,3453,1564,1564,0,1564,1511,53,3453,3453,0,0,3453,3412,2990,117,6,243,0,56,41,41,0,0,0,0,3453,162,3291,3453,1617,1836,2990,42,33500
42,101,33600,1132659,6364,2866,2866,0,2866,2734,132,6364,6364,0,0,6364,6280,5801,137,7,201,0,134,84,79,4,1,0,0,6364,267,6097,6364,3003,3361,5801,42,33600
42,101,33700,2038707,9328,4373,4373,0,4373,4208,165,9328,9328,0,0,9328,9185,8487,168,5,326,2,197,143,134,7,2,0,0,9328,425,8903,9328,4297,5031,8487,42,33700
42,101,33800,1391172,5981,2633,2633,0,2633,2544,89,5981,5981,0,0,5981,5924,5562,131,6,88,4,133,57,57,0,0,0,0,5981,257,5724,5981,2843,3138,5562,42,33800
42,101,33900,1137871,2749,1286,1286,0,1286,1221,65,2749,2749,0,0,2749,2708,2532,48,6,87,0,35,41,41,0,0,0,0,2749,93,2656,2749,1324,1425,2532,42,33900
42,101,34000,756688,2495,1020,1020,0,1020,993,27,2495,2495,0,0,2495,2489,2392,18,1,48,1,29,6,6,0,0,0,0,2495,72,2423,2495,1174,1321,2392,42,34000
42,101,34100,1351713,5627,2628,2628,0,2628,2505,123,5627,5627,0,0,5627,5553,5145,132,4,222,1,49,74,72,2,0,0,0,5627,123,5504,5627,2563,3064,5145,42,34100
42,101,34200,991519,3180,1449,1449,0,1449,1408,41,3180,3180,0,0,3180,3151,2841,170,3,113,0,24,29,28,1,0,0,0,3180,75,3105,3180,1388,1792,2841,42,34200
42,101,34300,5404820,195,73,73,0,73,68,5,195,195,0,0,195,195,188,3,0,3,0,1,0,0,0,0,0,0,195,5,190,195,96,99,188,42,34300
42,101,34400,3452579,7291,2762,2762,0,2762,2713,49,7291,7291,0,0,7291,7223,6603,65,6,492,0,57,68,66,2,0,0,0,7291,177,7114,7291,3441,3850,6603,42,34400
42,101,34500,1437725,8440,4378,4378,0,4378,4218,160,8440,8440,0,0,8440,8301,6756,605,11,784,3,142,139,134,4,1,0,0,8440,398,8042,8440,3723,4717,6756,42,34500
42,101,34600,1835045,1871,1125,1125,0,1125,1085,40,1871,1871,0,0,1871,1837,1277,429,4,89,1,37,34,33,1,0,0,0,1871,141,1730,1871,840,1031,1277,42,34600
42,101,34701,1143078,6083,2537,2537,0,2537,2460,77,6083,6083,0,0,6083,5965,4981,306,19,547,6,106,118,112,6,0,0,0,6083,304,5779,6083,2900,3183,4981,42,34701
42,101,34702,1006967,4052,1491,1491,0,1491,1447,44,4052,4052,0,0,4052,4007,3646,174,10,148,0,29,45,43,2,0,0,0,4052,112,3940,4052,1826,2226,3646,42,34702
42,101,34801,1398175,4286,1952,1952,0,1952,1899,53,4286,4286,0,0,4286,4257,4035,166,7,17,1,31,29,24,5,0,0,0,4286,88,4198,4286,2019,2267,4035,42,34801
42,101,34802,1218190,5458,2299,2299,0,2299,2218,81,5458,5458,0,0,5458,5374,4242,810,15,166,4,137,84,79,5,0,0,0,5458,345,5113,5458,2596,2862,4242,42,34802
42,101,34803,1299310,4495,1865,1865,0,1865,1786,79,4495,4495,0,0,4495,4441,4115,204,4,65,0,53,54,54,0,0,0,0,4495,142,4353,4495,2150,2345,4115,42,34803
42,101,34900,1957640,6589,2775,2775,0,2775,2572,203,6589,6589,0,0,6589,6437,4648,1459,14,154,2,160,152,146,3,2,1,0,6589,424,6165,6589,3030,3559,4648,42,34900
42,101,35100,984273,4637,2614,2614,0,2614,2499,115,4637,4637,0,0,4637,4594,4272,204,3,81,0,34,43,40,3,0,0,0,4637,112,4525,4637,1994,2643,4272,42,35100
42,101,35200,1867699,4370,1773,1773,0,1773,1716,57,4370,4370,0,0,4370,4319,4088,27,9,168,0,27,51,49,2,0,0,0,4370,63,4307,4370,2092,2278,4088,42,35200
42,101,35301,1519902,5495,2051,2051,0,2051,1995,56,5495,5495,0,0,5495,5438,5070,163,12,149,1,43,57,57,0,0,0,0,5495,131,5364,5495,2678,2817,5070,42,35301
42,101,35302,1539691,4479,1989,1989,0,1989,1936,53,4479,4479,0,0,4479,4429,4017,263,9,94,1,45,50,46,3,0,1,0,4479,111,4368,4479,2112,2367,4017,42,35302
42,101,35400,7649397,8,0,0,0,0,0,0,8,8,0,0,8,8,5,3,0,0,0,0,0,0,0,0,0,0,8,0,8,8,2,6,5,42,35400
42,101,35500,2327364,6793,3020,3020,0,3020,2909,111,6793,6793,0,0,6793,6693,6137,166,4,321,3,62,100,99,1,0,0,0,6793,212,6581,6793,3188,3605,6137,42,35500
42,101,35600,3439768,8789,3686,3686,0,3686,3599,87,8789,8789,0,0,8789,8704,7761,255,20,601,1,66,85,84,1,0,0,0,8789,232,8557,8789,4024,4765,7761,42,35600
42,101,35700,2146073,9027,3815,3815,0,3815,3651,164,9027,9027,0,0,9027,8794,6913,354,25,1350,2,150,233,220,13,0,0,0,9027,372,8655,9027,4334,4693,6913,42,35700
42,101,35800,1758885,5951,2359,2359,0,2359,2323,36,5951,5951,0,0,5951,5858,5235,189,5,389,4,36,93,92,1,0,0,0,5951,163,5788,5951,2854,3097,5235,42,35800
42,101,35900,2259042,5453,2229,2229,0,2229,2191,38,5453,5453,0,0,5453,5369,4729,127,13,442,2,56,84,80,4,0,0,0,5453,159,5294,5453,2530,2923,4729,42,35900
42,101,36000,2045095,2947,1017,1017,0,1017,994,23,2947,2947,0,0,2947,2878,2364,155,0,318,0,41,69,61,8,0,0,0,2947,77,2870,2947,1288,1659,2364,42,36000
42,101,36100,1216915,3976,1620,1620,0,1620,1506,114,3976,3976,0,0,3976,3913,3252,476,9,94,5,77,63,52,11,0,0,0,3976,219,3757,3976,1946,2030,3252,42,36100
42,101,36201,1049187,5063,2119,2119,0,2119,2072,47,5063,5063,0,0,5063,4992,4642,192,7,110,2,39,71,67,4,0,0,0,5063,135,4928,5063,2424,2639,4642,42,36201
42,101,36202,1139783,6334,2367,2367,0,2367,2315,52,6334,6334,0,0,6334,6247,5625,485,4,78,2,53,87,85,2,0,0,0,6334,155,6179,6334,3033,3301,5625,42,36202
42,101,36203,1470662,5279,1918,1918,0,1918,1867,51,5279,5279,0,0,5279,5230,4959,106,10,107,0,48,49,49,0,0,0,0,5279,136,5143,5279,2560,2719,4959,42,36203
42,101,36301,2398297,3866,1402,1402,0,1402,1353,49,3866,3866,0,0,3866,3817,3458,76,2,210,3,68,49,49,0,0,0,0,3866,141,3725,3866,1888,1978,3458,42,36301
42,101,36302,518680,3789,1344,1344,0,1344,1284,60,3789,3789,0,0,3789,3735,2995,527,7,121,0,85,54,49,5,0,0,0,3789,199,3590,3789,1892,1897,2995,42,36302
42,101,36303,2493805,7123,2485,2485,0,2485,2459,26,7123,7123,0,0,7123,7057,6832,74,9,92,1,49,66,62,4,0,0,0,7123,137,6986,7123,3461,3662,6832,42,36303
42,101,36400,4612211,304,18,18,0,18,14,4,304,304,0,0,304,296,198,85,1,0,1,11,8,8,0,0,0,0,304,30,274,304,235,69,198,42,36400
42,101,36500,3596082,9474,3745,3745,0,3745,3627,118,9474,9474,0,0,9474,9367,8542,455,13,271,3,83,107,101,6,0,0,0,9474,273,9201,9474,4514,4960,8542,42,36500
42,101,36600,1018874,644,383,383,0,383,373,10,644,644,0,0,644,634,562,50,1,19,0,2,10,10,0,0,0,0,644,16,628,644,343,301,562,42,36600
42,103,950100,196258271,6830,5163,5163,0,5163,2712,2451,6830,6830,0,0,6830,6757,6620,26,15,57,0,39,73,67,5,0,1,0,6830,212,6618,6830,3264,3566,6620,42,950100
42,103,950200,203465831,4154,3750,3750,0,3750,1694,2056,4154,4154,0,0,4154,4094,3941,107,8,18,0,20,60,53,7,0,0,0,4154,113,4041,4154,2085,2069,3941,42,950200
42,103,950300,89151501,3145,3838,3838,0,3838,1330,2508,3145,3145,0,0,3145,3118,3081,17,3,6,0,11,27,26,1,0,0,0,3145,50,3095,3145,1611,1534,3081,42,950300
42,103,950500,194982236,3621,3273,3273,0,3273,1382,1891,3621,3621,0,0,3621,3585,3345,122,7,26,1,84,36,35,1,0,0,0,3621,151,3470,3621,1894,1727,3345,42,950500
42,103,950600,184209071,11184,6843,6843,0,6843,4029,2814,11184,11184,0,0,11184,11026,10587,233,47,60,0,99,158,140,18,0,0,0,11184,511,10673,11184,5570,5614,10587,42,950600
42,103,950700,114003176,6319,3453,3453,0,3453,2244,1209,6319,6319,0,0,6319,6243,6016,136,9,28,0,54,76,74,2,0,0,0,6319,302,6017,6319,3136,3183,6016,42,950700
42,103,950800,126600829,7515,4655,4655,0,4655,2603,2052,7515,7515,0,0,7515,7308,6087,856,16,78,1,270,207,193,14,0,0,0,7515,881,6634,7515,3738,3777,6087,42,950800
42,103,950900,307556928,3534,3706,3706,0,3706,1439,2267,3534,3534,0,0,3534,3492,3432,16,6,12,1,25,42,40,2,0,0,0,3534,95,3439,3534,1776,1758,3432,42,950900
42,105,950100,695853387,4799,2751,2751,0,2751,1779,972,4799,4799,0,0,4799,4769,4728,13,18,3,1,6,30,29,1,0,0,0,4799,25,4774,4799,2417,2382,4728,42,950100
42,105,950200,408375654,3437,1914,1914,0,1914,1327,587,3437,3437,0,0,3437,3403,3383,3,5,5,2,5,34,34,0,0,0,0,3437,18,3419,3437,1703,1734,3383,42,950200
42,105,950300,182557768,4366,2182,2182,0,2182,1705,477,4366,4366,0,0,4366,4338,4242,18,6,60,2,10,28,27,1,0,0,0,4366,24,4342,4366,2139,2227,4242,42,950300
42,105,950400,879825301,3169,2978,2978,0,2978,1274,1704,3169,3169,0,0,3169,3148,3117,5,6,10,0,10,21,21,0,0,0,0,3169,25,3144,3169,1552,1617,3117,42,950400
42,105,950500,633592906,2309,2334,2334,0,2334,920,1414,2309,2309,0,0,2309,2293,2259,13,5,12,0,4,16,16,0,0,0,0,2309,11,2298,2309,1109,1200,2259,42,950500
42,107,100,177428657,4778,2267,2267,0,2267,1982,285,4778,4778,0,0,4778,4766,4727,6,2,12,0,19,12,12,0,0,0,0,4778,36,4742,4778,2375,2403,4727,42,100
42,107,200,851512,2274,1211,1211,0,1211,1034,177,2274,2274,0,0,2274,2273,2262,2,1,1,0,7,1,1,0,0,0,0,2274,15,2259,2274,1084,1190,2262,42,200
42,107,300,112002756,6035,2525,2525,0,2525,2320,205,6035,6035,0,0,6035,6010,5878,93,1,26,1,11,25,22,3,0,0,0,6035,46,5989,6035,2876,3159,5878,42,300
42,107,400,100345517,2563,1103,1103,0,1103,991,112,2563,2563,0,0,2563,2561,2555,2,2,1,0,1,2,2,0,0,0,0,2563,13,2550,2563,1307,1256,2555,42,400
42,107,500,1328323,4647,2595,2595,0,2595,2113,482,4647,4647,0,0,4647,4625,4591,10,4,10,0,10,22,21,1,0,0,0,4647,60,4587,4647,2192,2455,4591,42,500
42,107,600,3925410,5624,3339,3339,0,3339,2649,690,5624,5624,0,0,5624,5590,5478,19,14,20,2,57,34,34,0,0,0,0,5624,155,5469,5624,2569,3055,5478,42,600
42,107,700,30636296,7033,1977,1977,0,1977,1692,285,7033,7033,0,0,7033,7021,5133,1665,8,39,0,176,12,12,0,0,0,0,7033,320,6713,7033,4956,2077,5133,42,700
42,107,800,1545172,4361,2094,2094,0,2094,1914,180,4361,4361,0,0,4361,4356,4280,16,3,46,0,11,5,5,0,0,0,0,4361,31,4330,4361,2047,2314,4280,42,800
42,107,900,70610704,6111,2766,2766,0,2766,2495,271,6111,6111,0,0,6111,6096,6052,21,6,10,0,7,15,13,2,0,0,0,6111,11,6100,6111,2976,3135,6052,42,900
42,107,1000,4473309,3283,1724,1724,0,1724,1437,287,3283,3283,0,0,3283,3275,3263,7,0,3,0,2,8,8,0,0,0,0,3283,3,3280,3283,1590,1693,3263,42,1000
42,107,1100,139123152,2338,1016,1016,0,1016,883,133,2338,2338,0,0,2338,2338,2333,1,0,4,0,0,0,0,0,0,0,0,2338,7,2331,2338,1152,1186,2333,42,1100
42,107,1200,116798374,4408,1909,1909,0,1909,1792,117,4408,4408,0,0,4408,4397,4366,5,0,9,4,13,11,9,2,0,0,0,4408,30,4378,4408,2208,2200,4366,42,1200
42,107,1300,101770486,4126,1406,1406,0,1406,1288,118,4126,4126,0,0,4126,4106,3576,493,4,25,1,7,20,19,1,0,0,0,4126,204,3922,4126,2416,1710,3576,42,1300
42,107,1400,67789716,2778,1050,1050,0,1050,959,91,2778,2778,0,0,2778,2772,2517,244,0,8,0,3,6,6,0,0,0,0,2778,101,2677,2778,1649,1129,2517,42,1400
42,107,1500,1696617,4552,2312,2312,0,2312,2041,271,4552,4552,0,0,4552,4519,4484,20,3,8,1,3,33,29,4,0,0,0,4552,26,4526,4552,2102,2450,4484,42,1500
42,107,1600,45086542,4019,1671,1671,0,1671,1587,84,4019,4019,0,0,4019,4014,3982,5,6,17,0,4,5,5,0,0,0,0,4019,17,4002,4019,1996,2023,3982,42,1600
42,107,1700,5761695,3544,1498,1498,0,1498,1380,118,3544,3544,0,0,3544,3524,3430,26,2,44,0,22,20,16,4,0,0,0,3544,43,3501,3544,1700,1844,3430,42,1700
42,107,1800,1157672,2296,1108,1108,0,1108,1026,82,2296,2296,0,0,2296,2286,2236,38,3,3,0,6,10,10,0,0,0,0,2296,23,2273,2296,1007,1289,2236,42,1800
42,107,1900,1486914,5894,3102,3102,0,3102,2555,547,5894,5894,0,0,5894,5817,5523,218,9,25,1,41,77,72,5,0,0,0,5894,99,5795,5894,2852,3042,5523,42,1900
42,107,2000,2485664,3815,1635,1635,0,1635,1438,197,3815,3815,0,0,3815,3791,3696,70,5,7,0,13,24,21,3,0,0,0,3815,25,3790,3815,1688,2127,3696,42,2000
42,107,2100,3590915,1567,708,708,0,708,653,55,1567,1567,0,0,1567,1552,1546,2,0,4,0,0,15,15,0,0,0,0,1567,4,1563,1567,742,825,1546,42,2100
42,107,2200,12517978,2883,1310,1310,0,1310,1212,98,2883,2883,0,0,2883,2878,2858,14,1,1,1,3,5,5,0,0,0,0,2883,13,2870,2883,1375,1508,2858,42,2200
42,107,2300,3166302,3254,1647,1647,0,1647,1497,150,3254,3254,0,0,3254,3246,3212,22,3,2,0,7,8,7,1,0,0,0,3254,23,3231,3254,1527,1727,3212,42,2300
42,107,2400,76291077,2512,1251,1251,0,1251,1089,162,2512,2512,0,0,2512,2508,2497,0,1,9,0,1,4,4,0,0,0,0,2512,8,2504,2512,1248,1264,2497,42,2400
42,107,2500,84589371,2059,951,951,0,951,864,87,2059,2059,0,0,2059,2054,2047,1,3,3,0,0,5,5,0,0,0,0,2059,3,2056,2059,1013,1046,2047,42,2500
42,107,2600,8558252,4142,2129,2129,0,2129,1890,239,4142,4142,0,0,4142,4109,4090,3,1,9,0,6,33,30,3,0,0,0,4142,67,4075,4142,1986,2156,4090,42,2600
42,107,2700,16898896,3032,1473,1473,0,1473,1289,184,3032,3032,0,0,3032,3024,2990,10,5,7,0,12,8,7,1,0,0,0,3032,26,3006,3032,1452,1580,2990,42,2700
42,107,2800,5633211,2295,1209,1209,0,1209,1046,163,2295,2295,0,0,2295,2284,2257,7,1,6,0,13,11,11,0,0,0,0,2295,26,2269,2295,1071,1224,2257,42,2800
42,107,2900,197868998,4702,1990,1990,0,1990,1822,168,4702,4702,0,0,4702,4682,4647,9,4,9,0,13,20,14,6,0,0,0,4702,34,4668,4702,2383,2319,4647,42,2900
42,107,3000,114795756,5291,2183,2183,0,2183,2057,126,5291,5291,0,0,5291,5252,5145,8,4,90,0,5,39,37,1,1,0,0,5291,22,5269,5291,2636,2655,5145,42,3000
42,107,3100,5667771,3106,1217,1217,0,1217,1158,59,3106,3106,0,0,3106,3089,3035,10,1,34,2,7,17,17,0,0,0,0,3106,17,3089,3106,1399,1707,3035,42,3100
42,107,3200,56106943,5033,2109,2109,0,2109,1968,141,5033,5033,0,0,5033,5014,4951,19,6,33,2,3,19,18,1,0,0,0,5033,19,5014,5033,2508,2525,4951,42,3200
42,107,3300,3676667,5548,2551,2551,0,2551,2393,158,5548,5548,0,0,5548,5502,5394,42,8,39,3,16,46,45,1,0,0,0,5548,70,5478,5548,2645,2903,5394,42,3300
42,107,3400,59371395,3200,1378,1378,0,1378,1187,191,3200,3200,0,0,3200,3184,3153,17,0,6,0,8,16,16,0,0,0,0,3200,15,3185,3200,1582,1618,3153,42,3400
42,107,3500,90741467,4721,1972,1972,0,1972,1827,145,4721,4721,0,0,4721,4708,4661,11,2,23,0,11,13,10,3,0,0,0,4721,19,4702,4721,2350,2371,4661,42,3500
42,107,3600,80389113,2750,1082,1082,0,1082,1001,81,2750,2750,0,0,2750,2741,2725,5,0,8,1,2,9,9,0,0,0,0,2750,5,2745,2750,1408,1342,2725,42,3600
42,107,3700,108058672,3678,1705,1705,0,1705,1554,151,3678,3678,0,0,3678,3666,3653,3,0,3,0,7,12,10,2,0,0,0,3678,21,3657,3678,1788,1890,3653,42,3700
42,107,3800,2793595,2154,937,937,0,937,877,60,2154,2154,0,0,2154,2143,2127,3,0,11,0,2,11,10,1,0,0,0,2154,1,2153,2154,1016,1138,2127,42,3800
42,107,3900,98925096,3930,1696,1696,0,1696,1570,126,3930,3930,0,0,3930,3912,3899,0,1,10,0,2,18,18,0,0,0,0,3930,13,3917,3930,1947,1983,3899,42,3900
42,109,980100,45223423,5514,2498,2498,0,2498,2321,177,5514,5514,0,0,5514,5481,5391,19,4,55,0,12,33,28,3,0,2,0,5514,34,5480,5514,2659,2855,5391,42,980100
42,109,980200,122452009,7028,2548,2548,0,2548,2354,194,7028,7028,0,0,7028,7000,6821,109,2,35,0,33,28,28,0,0,0,0,7028,102,6926,7028,3617,3411,6821,42,980200
42,109,980300,131154693,5638,2335,2335,0,2335,2178,157,5638,5638,0,0,5638,5622,5585,18,7,4,1,7,16,14,2,0,0,0,5638,25,5613,5638,2748,2890,5585,42,980300
42,109,980400,240118511,5260,2178,2178,0,2178,1938,240,5260,5260,0,0,5260,5236,5223,5,0,3,0,5,24,24,0,0,0,0,5260,18,5242,5260,2622,2638,5223,42,980400
42,109,980500,177612731,3662,1604,1604,0,1604,1382,222,3662,3662,0,0,3662,3639,3631,4,0,4,0,0,23,23,0,0,0,0,3662,9,3653,3662,1783,1879,3631,42,980500
42,109,980600,136257648,5061,1815,1815,0,1815,1714,101,5061,5061,0,0,5061,5043,5021,5,1,6,1,9,18,18,0,0,0,0,5061,23,5038,5061,2566,2495,5021,42,980600
42,109,980700,4996500,5383,1912,1912,0,1912,1767,145,5383,5383,0,0,5383,5343,5096,147,4,49,0,47,40,32,8,0,0,0,5383,157,5226,5383,2357,3026,5096,42,980700
42,111,20101,53333435,2134,873,873,0,873,833,40,2134,2134,0,0,2134,2130,2129,1,0,0,0,0,4,4,0,0,0,0,2134,3,2131,2134,1048,1086,2129,42,20101
42,111,20102,54505479,5512,2299,2299,0,2299,2193,106,5512,5512,0,0,5512,5503,5482,2,5,9,1,4,9,9,0,0,0,0,5512,28,5484,5512,2616,2896,5482,42,20102
42,111,20200,177502744,4991,2069,2069,0,2069,1937,132,4991,4991,0,0,4991,4975,4961,6,0,5,0,3,16,16,0,0,0,0,4991,22,4969,4991,2412,2579,4961,42,20200
42,111,20300,5372463,4395,2177,2177,0,2177,2019,158,4395,4395,0,0,4395,4379,4364,0,3,4,1,7,16,16,0,0,0,0,4395,25,4370,4395,2025,2370,4364,42,20300
42,111,20400,175940569,4176,1893,1893,0,1893,1724,169,4176,4176,0,0,4176,4157,4149,3,1,3,0,1,19,19,0,0,0,0,4176,16,4160,4176,2075,2101,4149,42,20400
42,111,20500,93581875,3355,1440,1440,0,1440,1331,109,3355,3355,0,0,3355,3345,3336,3,4,1,0,1,10,10,0,0,0,0,3355,10,3345,3355,1642,1713,3336,42,20500
42,111,20600,174216504,6132,2797,2797,0,2797,2508,289,6132,6132,0,0,6132,6112,6095,2,5,5,0,5,20,20,0,0,0,0,6132,11,6121,6132,3003,3129,6095,42,20600
42,111,20700,173699580,3044,1899,1899,0,1899,1174,725,3044,3044,0,0,3044,3039,3024,7,1,3,0,4,5,5,0,0,0,0,3044,10,3034,3044,1570,1474,3024,42,20700
42,111,20800,78966527,4095,1690,1690,0,1690,1587,103,4095,4095,0,0,4095,4074,4026,3,3,38,0,4,21,21,0,0,0,0,4095,11,4084,4095,1981,2114,4026,42,20800
42,111,20900,86564227,5224,2009,2009,0,2009,1897,112,5224,5224,0,0,5224,5210,5032,135,3,12,0,28,14,13,1,0,0,0,5224,35,5189,5224,2779,2445,5032,42,20900
42,111,21000,4206435,4356,1996,1996,0,1996,1866,130,4356,4356,0,0,4356,4339,4266,22,3,34,2,12,17,17,0,0,0,0,4356,25,4331,4356,1921,2435,4266,42,21000
42,111,21100,2895463,2406,1317,1317,0,1317,1169,148,2406,2406,0,0,2406,2389,2347,25,3,13,0,1,17,16,1,0,0,0,2406,12,2394,2406,1130,1276,2347,42,21100
42,111,21200,168431083,2916,1681,1681,0,1681,1122,559,2916,2916,0,0,2916,2904,2890,2,7,3,0,2,12,10,0,2,0,0,2916,7,2909,2916,1466,1450,2890,42,21200
42,111,21300,462050034,3515,1794,1794,0,1794,1320,474,3515,3515,0,0,3515,3492,3458,7,5,9,0,13,23,22,1,0,0,0,3515,14,3501,3515,1794,1721,3458,42,21300
42,111,21400,164704182,6376,1857,1857,0,1857,1743,114,6376,6376,0,0,6376,6310,5090,1034,6,21,0,159,66,65,1,0,0,0,6376,239,6137,6376,3983,2393,5090,42,21400
42,111,21500,118621627,2817,1110,1110,0,1110,1032,78,2817,2817,0,0,2817,2802,2794,5,2,1,0,0,15,15,0,0,0,0,2817,1,2816,2817,1409,1408,2794,42,21500
42,111,21600,2170700,2473,1089,1089,0,1089,1019,70,2473,2473,0,0,2473,2470,2457,6,3,4,0,0,3,3,0,0,0,0,2473,18,2455,2473,1134,1339,2457,42,21600
42,111,21700,148480656,3171,1287,1287,0,1287,1152,135,3171,3171,0,0,3171,3160,3154,0,0,0,2,4,11,11,0,0,0,0,3171,22,3149,3171,1548,1623,3154,42,21700
42,111,21800,186082725,3771,1607,1607,0,1607,1493,114,3771,3771,0,0,3771,3766,3752,9,2,3,0,0,5,5,0,0,0,0,3771,5,3766,3771,1857,1914,3752,42,21800
42,111,21900,452027159,5164,4279,4279,0,4279,2103,2176,5164,5164,0,0,5164,5150,5132,3,9,4,0,2,14,14,0,0,0,0,5164,18,5146,5164,2574,2590,5132,42,21900
42,113,980100,443302844,3691,2845,2845,0,2845,1473,1372,3691,3691,0,0,3691,3653,3454,137,31,3,0,28,38,36,2,0,0,0,3691,63,3628,3691,1876,1815,3454,42,980100
42,113,980200,722024962,2865,3172,3172,0,3172,1187,1985,2865,2865,0,0,2865,2847,2812,7,19,7,0,2,18,18,0,0,0,0,2865,9,2856,2865,1436,1429,2812,42,980200
42,115,32000,273115067,3219,1675,1675,0,1675,1236,439,3219,3219,0,0,3219,3192,3176,2,5,4,1,4,27,24,3,0,0,0,3219,30,3189,3219,1650,1569,3176,42,32000
42,115,32100,223394565,3933,2098,2098,0,2098,1462,636,3933,3933,0,0,3933,3897,3867,9,10,3,1,7,36,36,0,0,0,0,3933,20,3913,3933,1964,1969,3867,42,32100
42,115,32200,95786767,3806,1747,1747,0,1747,1600,147,3806,3806,0,0,3806,3788,3744,12,9,15,0,8,18,16,2,0,0,0,3806,17,3789,3806,1864,1942,3744,42,32200
42,115,32300,133406904,4008,1875,1875,0,1875,1538,337,4008,4008,0,0,4008,3989,3943,3,4,35,2,2,19,19,0,0,0,0,4008,45,3963,4008,1938,2070,3943,42,32300
42,115,32400,326380961,4154,2935,2935,0,2935,1650,1285,4154,4154,0,0,4154,4120,4081,13,8,10,0,8,34,34,0,0,0,0,4154,46,4108,4154,2106,2048,4081,42,32400
42,115,32500,203089982,4038,2276,2276,0,2276,1584,692,4038,4038,0,0,4038,4020,3975,21,9,6,0,9,18,18,0,0,0,0,4038,30,4008,4038,2028,2010,3975,42,32500
42,115,32600,108302634,4332,2079,2079,0,2079,1792,287,4332,4332,0,0,4332,4302,4255,26,5,6,0,10,30,30,0,0,0,0,4332,20,4312,4332,2084,2248,4255,42,32600
42,115,32700,284270452,3670,1752,1752,0,1752,1376,376,3670,3670,0,0,3670,3638,3616,12,1,3,0,6,32,27,5,0,0,0,3670,15,3655,3670,1895,1775,3616,42,32700
42,115,32800,272754463,5010,2328,2328,0,2328,1891,437,5010,5010,0,0,5010,4986,4947,16,5,6,1,11,24,20,4,0,0,0,5010,25,4985,5010,2516,2494,4947,42,32800
42,115,32901,208362922,4213,2127,2127,0,2127,1610,517,4213,4213,0,0,4213,4198,4172,12,4,3,1,6,15,14,1,0,0,0,4213,25,4188,4213,2128,2085,4172,42,32901
42,115,32902,2339875,1855,937,937,0,937,790,147,1855,1855,0,0,1855,1853,1845,2,3,1,0,2,2,2,0,0,0,0,1855,12,1843,1855,830,1025,1845,42,32902
42,117,990100,195769299,4402,1903,1903,0,1903,1698,205,4402,4402,0,0,4402,4377,4358,11,3,4,0,1,25,24,1,0,0,0,4402,14,4388,4402,2191,2211,4358,42,990100
42,117,990200,154344399,3709,1684,1684,0,1684,1492,192,3709,3709,0,0,3709,3681,3652,22,4,1,0,2,28,24,4,0,0,0,3709,18,3691,3709,1785,1924,3652,42,990200
42,117,990300,223606383,3758,1731,1731,0,1731,1488,243,3758,3758,0,0,3758,3740,3709,16,7,4,0,4,18,18,0,0,0,0,3758,19,3739,3758,1847,1911,3709,42,990300
42,117,990400,404000317,4022,2149,2149,0,2149,1568,581,4022,4022,0,0,4022,4007,3975,2,9,6,0,15,15,15,0,0,0,0,4022,19,4003,4022,2046,1976,3975,42,990400
42,117,990500,415092914,4330,2115,2115,0,2115,1644,471,4330,4330,0,0,4330,4294,4254,7,22,10,1,0,36,26,10,0,0,0,4330,15,4315,4330,2163,2167,4254,42,990500
42,117,990600,136460644,5886,2079,2079,0,2079,1913,166,5886,5886,0,0,5886,5831,5600,153,20,39,0,19,55,55,0,0,0,0,5886,51,5835,5886,2798,3088,5600,42,990600
42,117,990700,208332669,5067,2239,2239,0,2239,1988,251,5067,5067,0,0,5067,5032,4986,10,7,22,2,5,35,31,4,0,0,0,5067,43,5024,5067,2471,2596,4986,42,990700
42,117,990800,12657304,3328,1602,1602,0,1602,1469,133,3328,3328,0,0,3328,3321,3266,13,6,30,0,6,7,6,1,0,0,0,3328,19,3309,3328,1488,1840,3266,42,990800
42,117,990900,652284286,3969,2660,2660,0,2660,1552,1108,3969,3969,0,0,3969,3946,3915,13,11,4,0,3,23,23,0,0,0,0,3969,8,3961,3969,1974,1995,3915,42,990900
42,117,991000,533787981,2902,1731,1731,0,1731,1113,618,2902,2902,0,0,2902,2890,2874,3,7,4,1,1,12,11,1,0,0,0,2902,8,2894,2902,1490,1412,2874,42,991000
42,119,990100,159491254,8960,2088,2088,0,2088,1979,109,8960,8960,0,0,8960,8665,6780,1742,14,100,2,27,295,268,27,0,0,0,8960,994,7966,8960,6332,2628,6780,42,990100
42,119,990200,406905307,6104,2980,2980,0,2980,2184,796,6104,6104,0,0,6104,6063,6007,22,8,13,2,11,41,38,0,3,0,0,6104,40,6064,6104,3053,3051,6007,42,990200
42,119,990300,4950427,3664,1629,1629,0,1629,1529,100,3664,3664,0,0,3664,3638,3597,16,3,9,1,12,26,26,0,0,0,0,3664,27,3637,3664,1710,1954,3597,42,990300
42,119,990400,82240562,3837,1571,1571,0,1571,1406,165,3837,3837,0,0,3837,3813,3763,12,16,15,1,6,24,21,3,0,0,0,3837,13,3824,3837,1971,1866,3763,42,990400
42,119,990500,123680815,7709,2584,2584,0,2584,2479,105,7709,7709,0,0,7709,7656,6704,870,14,47,1,20,53,51,2,0,0,0,7709,310,7399,7709,4572,3137,6704,42,990500
42,119,990600,40505975,5730,1894,1894,0,1894,1823,71,5730,5730,0,0,5730,5696,5499,69,2,102,4,20,34,34,0,0,0,0,5730,107,5623,5730,2779,2951,5499,42,990600
42,119,990700,2542604,5620,1938,1938,0,1938,1778,160,5620,5620,0,0,5620,5522,5146,147,10,157,6,56,98,93,5,0,0,0,5620,131,5489,5620,2619,3001,5146,42,990700
42,121,200000,221967326,3514,1613,1613,0,1613,1369,244,3514,3514,0,0,3514,3491,3474,3,8,5,0,1,23,23,0,0,0,0,3514,9,3505,3514,1792,1722,3474,42,200000
42,121,200100,209446820,4253,1763,1763,0,1763,1575,188,4253,4253,0,0,4253,4233,4208,11,4,6,0,4,20,19,1,0,0,0,4253,12,4241,4253,2119,2134,4208,42,200100
42,121,200200,194164586,6261,2465,2465,0,2465,2151,314,6261,6261,0,0,6261,6205,5953,200,13,8,1,30,56,50,6,0,0,0,6261,58,6203,6261,3230,3031,5953,42,200200
42,121,200300,4733411,1857,787,787,0,787,737,50,1857,1857,0,0,1857,1832,1745,62,5,8,1,11,25,23,2,0,0,0,1857,15,1842,1857,819,1038,1745,42,200300
42,121,200400,4236441,2642,1333,1333,0,1333,1224,109,2642,2642,0,0,2642,2594,2513,67,1,10,0,3,48,44,4,0,0,0,2642,10,2632,2642,1192,1450,2513,42,200400
42,121,200500,3002383,2713,1161,1161,0,1161,1069,92,2713,2713,0,0,2713,2687,2577,96,0,6,0,8,26,26,0,0,0,0,2713,23,2690,2713,1324,1389,2577,42,200500
42,121,200600,96759332,5331,2245,2245,0,2245,2093,152,5331,5331,0,0,5331,5304,5264,17,7,10,0,6,27,27,0,0,0,0,5331,15,5316,5331,2538,2793,5264,42,200600
42,121,200700,3268268,2470,1177,1177,0,1177,1009,168,2470,2470,0,0,2470,2458,2419,24,11,2,0,2,12,10,2,0,0,0,2470,25,2445,2470,1162,1308,2419,42,200700
42,121,200800,2444726,2660,1191,1191,0,1191,1100,91,2660,2660,0,0,2660,2644,2592,19,7,17,0,9,16,15,1,0,0,0,2660,13,2647,2660,1281,1379,2592,42,200800
42,121,200900,1082305,2799,1366,1366,0,1366,1227,139,2799,2799,0,0,2799,2775,2739,24,3,6,2,1,24,20,4,0,0,0,2799,21,2778,2799,1322,1477,2739,42,200900
42,121,201000,4896226,3575,1542,1542,0,1542,1426,116,3575,3575,0,0,3575,3562,3506,35,9,8,3,1,13,12,1,0,0,0,3575,13,3562,3575,1703,1872,3506,42,201000
42,121,201100,291619598,5040,2714,2714,0,2714,1990,724,5040,5040,0,0,5040,5022,4988,15,8,9,0,2,18,18,0,0,0,0,5040,18,5022,5040,2468,2572,4988,42,201100
42,121,201200,84059631,3184,1378,1378,0,1378,1281,97,3184,3184,0,0,3184,3173,3157,6,5,4,0,1,11,11,0,0,0,0,3184,13,3171,3184,1563,1621,3157,42,201200
42,121,201300,98234712,3830,1676,1676,0,1676,1562,114,3830,3830,0,0,3830,3818,3764,16,12,10,0,16,12,12,0,0,0,0,3830,33,3797,3830,1840,1990,3764,42,201300
42,121,201400,273609076,3773,1941,1941,0,1941,1448,493,3773,3773,0,0,3773,3743,3695,23,7,15,0,3,30,30,0,0,0,0,3773,7,3766,3773,1940,1833,3695,42,201400
42,121,201500,254815529,3663,2552,2552,0,2552,1486,1066,3663,3663,0,0,3663,3639,3614,8,5,8,4,0,24,22,2,0,0,0,3663,13,3650,3663,1810,1853,3614,42,201500
42,123,970100,311388997,2670,1459,1459,0,1459,1083,376,2670,2670,0,0,2670,2645,2635,1,1,7,1,0,25,24,1,0,0,0,2670,10,2660,2670,1347,1323,2635,42,970100
42,123,970200,191039758,4065,1716,1716,0,1716,1562,154,4065,4065,0,0,4065,4043,4003,11,7,19,0,3,22,22,0,0,0,0,4065,15,4050,4065,2071,1994,4003,42,970200
42,123,970300,294005068,5819,2293,2293,0,2293,2073,220,5819,5819,0,0,5819,5780,5752,9,13,3,0,3,39,39,0,0,0,0,5819,11,5808,5819,2883,2936,5752,42,970300
42,123,970400,363914133,3100,1837,1837,0,1837,1185,652,3100,3100,0,0,3100,3092,3076,8,5,0,0,3,8,8,0,0,0,0,3100,6,3094,3100,1608,1492,3076,42,970400
42,123,970500,103476722,3902,1774,1774,0,1774,1532,242,3902,3902,0,0,3902,3891,3867,0,15,5,0,4,11,8,3,0,0,0,3902,13,3889,3902,1815,2087,3867,42,970500
42,123,970600,77624225,3915,1659,1659,0,1659,1526,133,3915,3915,0,0,3915,3893,3826,24,10,16,2,15,22,22,0,0,0,0,3915,23,3892,3915,1949,1966,3826,42,970600
42,123,970700,1709186,2775,1263,1263,0,1263,1186,77,2775,2775,0,0,2775,2767,2749,3,3,11,1,0,8,8,0,0,0,0,2775,10,2765,2775,1320,1455,2749,42,970700
42,123,970800,3352918,3691,1906,1906,0,1906,1680,226,3691,3691,0,0,3691,3665,3625,12,4,20,1,3,26,26,0,0,0,0,3691,19,3672,3691,1746,1945,3625,42,970800
42,123,970900,2511607,3793,1877,1877,0,1877,1699,178,3793,3793,0,0,3793,3770,3734,6,14,6,0,10,23,23,0,0,0,0,3793,11,3782,3793,1751,2042,3734,42,970900
42,123,971000,91674573,2319,1071,1071,0,1071,961,110,2319,2319,0,0,2319,2314,2286,3,1,21,0,3,5,5,0,0,0,0,2319,3,2316,2319,1152,1167,2286,42,971000
42,123,971100,297831481,3268,2798,2798,0,2798,1343,1455,3268,3268,0,0,3268,3249,3232,1,5,7,0,4,19,15,0,1,3,0,3268,12,3256,3268,1585,1683,3232,42,971100
42,123,971200,273663190,2574,1645,1645,0,1645,1047,598,2574,2574,0,0,2574,2562,2544,6,4,1,3,4,12,12,0,0,0,0,2574,17,2557,2574,1275,1299,2544,42,971200
42,123,971400,275924640,1972,1760,1760,0,1760,819,941,1972,1972,0,0,1972,1965,1957,6,0,2,0,0,7,7,0,0,0,0,1972,1,1971,1972,1004,968,1957,42,971400
42,125,704100,910790,1374,788,788,0,788,638,150,1374,1374,0,0,1374,1330,972,335,1,3,0,19,44,44,0,0,0,0,1374,31,1343,1374,677,697,972,42,704100
42,125,711000,185950118,4013,1618,1618,0,1618,1549,69,4013,4013,0,0,4013,4003,3954,28,4,8,1,8,10,10,0,0,0,0,4013,20,3993,4013,2026,1987,3954,42,711000
42,125,712700,1612249,1576,703,703,0,703,656,47,1576,1576,0,0,1576,1550,1517,23,1,1,0,8,26,25,1,0,0,0,1576,39,1537,1576,731,845,1517,42,712700
42,125,713700,89053243,4567,1928,1928,0,1928,1813,115,4567,4567,0,0,4567,4545,4449,83,3,5,0,5,22,21,1,0,0,0,4567,44,4523,4567,2265,2302,4449,42,713700
42,125,714000,55937018,3175,1333,1333,0,1333,1252,81,3175,3175,0,0,3175,3153,3065,78,5,4,0,1,22,17,5,0,0,0,3175,10,3165,3175,1564,1611,3065,42,714000
42,125,715700,818318,1866,954,954,0,954,850,104,1866,1866,0,0,1866,1844,1713,122,3,0,2,4,22,20,2,0,0,0,1866,6,1860,1866,890,976,1713,42,715700
42,125,721000,188325927,4497,1796,1796,0,1796,1684,112,4497,4497,0,0,4497,4456,4417,30,5,0,4,0,41,33,8,0,0,0,4497,7,4490,4497,2306,2191,4417,42,721000
42,125,722700,92294121,3422,1348,1348,0,1348,1279,69,3422,3422,0,0,3422,3407,3302,102,0,3,0,0,15,15,0,0,0,0,3422,3,3419,3422,1711,1711,3302,42,722700
42,125,731000,191759817,6169,2408,2408,0,2408,2283,125,6169,6169,0,0,6169,6135,6106,12,4,7,2,4,34,34,0,0,0,0,6169,15,6154,6169,3027,3142,6106,42,731000
42,125,732000,321440257,7526,2836,2836,0,2836,2649,187,7526,7526,0,0,7526,7501,7464,15,6,13,0,3,25,23,2,0,0,0,7526,24,7502,7526,3817,3709,7464,42,732000
42,125,741100,30666759,4107,1599,1599,0,1599,1531,68,4107,4107,0,0,4107,4086,4029,49,1,4,0,3,21,20,1,0,0,0,4107,21,4086,4107,2038,2069,4029,42,741100
42,125,741200,10623308,1961,760,760,0,760,727,33,1961,1961,0,0,1961,1947,1918,19,1,2,2,5,14,14,0,0,0,0,1961,11,1950,1961,951,1010,1918,42,741200
42,125,741300,19566874,3190,1392,1392,0,1392,1329,63,3190,3190,0,0,3190,3177,3068,80,6,16,2,5,13,13,0,0,0,0,3190,20,3170,3190,1507,1683,3068,42,741300
42,125,741400,7375839,498,254,254,0,254,207,47,498,498,0,0,498,497,489,6,0,2,0,0,1,1,0,0,0,0,498,0,498,498,251,247,489,42,741400
42,125,742100,25516228,5315,2187,2187,0,2187,2097,90,5315,5315,0,0,5315,5285,5027,243,1,7,1,6,30,27,3,0,0,0,5315,21,5294,5315,2531,2784,5027,42,742100
42,125,742200,38003536,1839,751,751,0,751,717,34,1839,1839,0,0,1839,1827,1798,20,1,2,3,3,12,12,0,0,0,0,1839,5,1834,1839,905,934,1798,42,742200
42,125,743700,950178,1314,668,668,0,668,614,54,1314,1314,0,0,1314,1299,1241,48,1,7,0,2,15,13,2,0,0,0,1314,5,1309,1314,612,702,1241,42,743700
42,125,744100,3672660,5289,2645,2645,0,2645,2429,216,5289,5289,0,0,5289,5188,4757,378,4,36,2,11,101,87,13,1,0,0,5289,41,5248,5289,2464,2825,4757,42,744100
42,125,744200,2346476,3318,1499,1499,0,1499,1380,119,3318,3318,0,0,3318,3290,3076,184,1,19,5,5,28,26,2,0,0,0,3318,21,3297,3318,1549,1769,3076,42,744200
42,125,745100,16431781,6424,2752,2752,0,2752,2608,144,6424,6424,0,0,6424,6398,6164,142,1,74,2,15,26,26,0,0,0,0,6424,43,6381,6424,3062,3362,6164,42,745100
42,125,745200,54281592,3633,1404,1404,0,1404,1367,37,3633,3633,0,0,3633,3617,3536,67,0,7,0,7,16,14,2,0,0,0,3633,18,3615,3633,1831,1802,3536,42,745200
42,125,746100,10030174,5979,2219,2219,0,2219,2159,60,5979,5979,0,0,5979,5963,5857,51,2,44,0,9,16,15,1,0,0,0,5979,47,5932,5979,2865,3114,5857,42,746100
42,125,746200,9203243,3508,1257,1257,0,1257,1231,26,3508,3508,0,0,3508,3495,3451,12,2,20,0,10,13,13,0,0,0,0,3508,23,3485,3508,1731,1777,3451,42,746200
42,125,746300,31511569,8079,2745,2745,0,2745,2636,109,8079,8079,0,0,8079,8043,7873,21,1,127,5,16,36,33,2,1,0,0,8079,57,8022,8079,3929,4150,7873,42,746300
42,125,751100,25006371,5391,2319,2319,0,2319,2220,99,5391,5391,0,0,5391,5337,5222,95,4,8,0,8,54,53,1,0,0,0,5391,24,5367,5391,2515,2876,5222,42,751100
42,125,751200,13558957,3435,1452,1452,0,1452,1359,93,3435,3435,0,0,3435,3397,3209,171,2,9,0,6,38,38,0,0,0,0,3435,17,3418,3435,1648,1787,3209,42,751200
42,125,752700,18844729,4818,2052,2052,0,2052,1964,88,4818,4818,0,0,4818,4788,4642,116,8,19,0,3,30,28,2,0,0,0,4818,17,4801,4818,2184,2634,4642,42,752700
42,125,753700,1183027,1930,983,983,0,983,903,80,1930,1930,0,0,1930,1911,1815,82,4,7,2,1,19,17,1,1,0,0,1930,4,1926,1930,918,1012,1815,42,753700
42,125,754200,2554000,3212,1162,1162,0,1162,1051,111,3212,3212,0,0,3212,3157,2892,230,6,20,0,9,55,51,4,0,0,0,3212,31,3181,3212,1577,1635,2892,42,754200
42,125,754300,1173951,3879,1862,1862,0,1862,1632,230,3879,3879,0,0,3879,3775,2740,973,1,29,3,29,104,90,13,1,0,0,3879,36,3843,3879,1735,2144,2740,42,754300
42,125,754400,774899,2195,1004,1004,0,1004,888,116,2195,2195,0,0,2195,2138,1788,322,8,5,0,15,57,57,0,0,0,0,2195,20,2175,2195,1025,1170,1788,42,754400
42,125,754500,1430622,2855,1416,1416,0,1416,1263,153,2855,2855,0,0,2855,2804,2570,217,1,3,0,13,51,49,2,0,0,0,2855,22,2833,2855,1318,1537,2570,42,754500
42,125,754600,761543,1753,879,879,0,879,787,92,1753,1753,0,0,1753,1714,1539,152,6,9,0,8,39,37,2,0,0,0,1753,4,1749,1753,828,925,1539,42,754600
42,125,755100,14770131,3280,1566,1566,0,1566,1505,61,3280,3280,0,0,3280,3268,3193,63,0,4,1,7,12,11,1,0,0,0,3280,16,3264,3280,1386,1894,3193,42,755100
42,125,755200,45067144,4707,1878,1878,0,1878,1815,63,4707,4707,0,0,4707,4688,4582,63,4,35,0,4,19,19,0,0,0,0,4707,16,4691,4707,2299,2408,4582,42,755200
42,125,755700,116149945,3960,1566,1566,0,1566,1492,74,3960,3960,0,0,3960,3935,3903,24,5,3,0,0,25,25,0,0,0,0,3960,7,3953,3960,1945,2015,3903,42,755700
42,125,761000,147820917,5663,2380,2380,0,2380,2216,164,5663,5663,0,0,5663,5641,5614,11,0,7,0,9,22,21,1,0,0,0,5663,13,5650,5663,2794,2869,5614,42,761000
42,125,762000,87498142,2867,1207,1207,0,1207,1139,68,2867,2867,0,0,2867,2849,2774,66,5,2,0,2,18,18,0,0,0,0,2867,3,2864,2867,1401,1466,2774,42,762000
42,125,763700,42172126,1793,764,764,0,764,722,42,1793,1793,0,0,1793,1776,1692,68,8,7,1,0,17,17,0,0,0,0,1793,11,1782,1793,904,889,1692,42,763700
42,125,764000,11479045,3717,1762,1762,0,1762,1609,153,3717,3717,0,0,3717,3659,3579,71,3,2,0,4,58,58,0,0,0,0,3717,22,3695,3717,1762,1955,3579,42,764000
42,125,771100,81841677,4991,2045,2045,0,2045,1967,78,4991,4991,0,0,4991,4962,4923,29,1,6,0,3,29,17,12,0,0,0,4991,6,4985,4991,2515,2476,4923,42,771100
42,125,771200,10901259,3589,1605,1605,0,1605,1541,64,3589,3589,0,0,3589,3569,3498,50,1,9,0,11,20,20,0,0,0,0,3589,32,3557,3589,1716,1873,3498,42,771200
42,125,772700,2675926,2262,1068,1068,0,1068,962,106,2262,2262,0,0,2262,2238,2194,25,3,11,2,3,24,12,0,0,12,0,2262,2,2260,2262,1072,1190,2194,42,772700
42,125,773100,4266205,3194,1675,1675,0,1675,1497,178,3194,3194,0,0,3194,3164,3054,83,3,6,0,18,30,27,3,0,0,0,3194,24,3170,3194,1488,1706,3054,42,773100
42,125,773200,721314,1567,707,707,0,707,642,65,1567,1567,0,0,1567,1544,1466,72,1,3,0,2,23,19,4,0,0,0,1567,10,1557,1567,704,863,1466,42,773200
42,125,774700,34976342,5677,2344,2344,0,2344,2265,79,5677,5677,0,0,5677,5664,5578,62,3,6,3,12,13,13,0,0,0,0,5677,42,5635,5677,2736,2941,5578,42,774700
42,125,775200,2930594,2947,1557,1557,0,1557,1302,255,2947,2947,0,0,2947,2874,2354,488,7,14,0,11,73,71,2,0,0,0,2947,71,2876,2947,1310,1637,2354,42,775200
42,125,775300,1992788,2706,1401,1401,0,1401,1167,234,2706,2706,0,0,2706,2648,2287,351,1,1,1,7,58,55,3,0,0,0,2706,43,2663,2706,1249,1457,2287,42,775300
42,125,781700,55125204,4461,1878,1878,0,1878,1765,113,4461,4461,0,0,4461,4442,4365,64,3,7,0,3,19,19,0,0,0,0,4461,28,4433,4461,2179,2282,4365,42,781700
42,125,782700,680567,1409,706,706,0,706,650,56,1409,1409,0,0,1409,1397,1369,25,1,0,0,2,12,12,0,0,0,0,1409,18,1391,1409,633,776,1369,42,782700
42,125,783200,945819,2829,1584,1584,0,1584,1352,232,2829,2829,0,0,2829,2809,2705,90,5,7,0,2,20,20,0,0,0,0,2829,19,2810,2829,1274,1555,2705,42,783200
42,125,783300,1053957,2042,1072,1072,0,1072,906,166,2042,2042,0,0,2042,2023,1938,68,1,7,0,9,19,17,2,0,0,0,2042,16,2026,2042,912,1130,1938,42,783300
42,125,784000,13752536,2983,1385,1385,0,1385,1304,81,2983,2983,0,0,2983,2975,2939,19,0,17,0,0,8,8,0,0,0,0,2983,6,2977,2983,1435,1548,2939,42,784000
42,125,791000,9715104,1749,788,788,0,788,744,44,1749,1749,0,0,1749,1742,1715,17,1,4,0,5,7,7,0,0,0,0,1749,5,1744,1749,818,931,1715,42,791000
42,125,792100,26264123,2739,1367,1367,0,1367,1260,107,2739,2739,0,0,2739,2721,2617,75,2,24,0,3,18,17,1,0,0,0,2739,15,2724,2739,1258,1481,2617,42,792100
42,125,792200,2596149,2669,797,797,0,797,690,107,2669,2669,0,0,2669,2635,2466,143,7,15,0,4,34,30,4,0,0,0,2669,13,2656,2669,1335,1334,2466,42,792200
42,125,793700,3347806,1075,527,527,0,527,459,68,1075,1075,0,0,1075,1071,1055,7,1,0,0,8,4,4,0,0,0,0,1075,4,1071,1075,528,547,1055,42,793700
42,125,794700,34307564,3390,1455,1455,0,1455,1359,96,3390,3390,0,0,3390,3377,3351,6,5,7,0,8,13,10,3,0,0,0,3390,9,3381,3390,1633,1757,3351,42,794700
42,125,795700,13232978,2524,1210,1210,0,1210,1048,162,2524,2524,0,0,2524,2500,2426,60,10,1,0,3,24,24,0,0,0,0,2524,12,2512,2524,1172,1352,2426,42,795700
42,127,960100,229064865,1544,1280,1280,0,1280,630,650,1544,1544,0,0,1544,1539,1526,2,0,6,0,5,5,5,0,0,0,0,1544,8,1536,1544,800,744,1526,42,960100
42,127,960200,411084419,3337,2464,2464,0,2464,1346,1118,3337,3337,0,0,3337,3323,3304,2,4,8,0,5,14,14,0,0,0,0,3337,39,3298,3337,1684,1653,3304,42,960200
42,127,960300,103637443,2169,1210,1210,0,1210,866,344,2169,2169,0,0,2169,2165,2143,11,5,5,0,1,4,4,0,0,0,0,2169,4,2165,2169,1082,1087,2143,42,960300
42,127,960400,201494063,3035,1465,1465,0,1465,1150,315,3035,3035,0,0,3035,3020,2994,10,0,15,0,1,15,12,3,0,0,0,3035,24,3011,3035,1522,1513,2994,42,960400
42,127,960500,204944989,3662,2248,2248,0,2248,1454,794,3662,3662,0,0,3662,3652,3603,22,12,12,0,3,10,10,0,0,0,0,3662,37,3625,3662,1827,1835,3603,42,960500
42,127,960600,142699212,4618,2257,2257,0,2257,1854,403,4618,4618,0,0,4618,4580,4509,31,3,20,0,17,38,38,0,0,0,0,4618,86,4532,4618,2206,2412,4509,42,960600
42,127,960700,10672151,4874,2414,2414,0,2414,2166,248,4874,4874,0,0,4874,4844,4759,32,7,38,0,8,30,28,2,0,0,0,4874,92,4782,4874,2218,2656,4759,42,960700
42,127,960800,93117769,4318,1926,1926,0,1926,1669,257,4318,4318,0,0,4318,4288,4220,24,15,22,0,7,30,28,2,0,0,0,4318,47,4271,4318,2069,2249,4220,42,960800
42,127,960900,126358051,5011,1626,1626,0,1626,1411,215,5011,5011,0,0,5011,4985,4427,403,5,16,0,134,26,26,0,0,0,0,5011,168,4843,5011,3007,2004,4427,42,960900
42,127,961000,72764796,4361,3524,3524,0,3524,1632,1892,4361,4361,0,0,4361,4335,4236,70,5,8,0,16,26,21,5,0,0,0,4361,69,4292,4361,2109,2252,4236,42,961000
42,127,961100,72814622,2959,3398,3398,0,3398,1176,2222,2959,2959,0,0,2959,2940,2889,25,2,11,1,12,19,19,0,0,0,0,2959,74,2885,2959,1454,1505,2889,42,961100
42,127,961200,79739785,3664,2757,2757,0,2757,1400,1357,3664,3664,0,0,3664,3619,3564,32,6,7,0,10,45,43,2,0,0,0,3664,52,3612,3664,1865,1799,3564,42,961200
42,127,961300,108490055,2531,1570,1570,0,1570,961,609,2531,2531,0,0,2531,2501,2441,41,4,6,0,9,30,30,0,0,0,0,2531,37,2494,2531,1266,1265,2441,42,961300
42,127,961400,31780499,1639,2454,2454,0,2454,635,1819,1639,1639,0,0,1639,1627,1545,52,1,8,0,21,12,12,0,0,0,0,1639,74,1565,1639,833,806,1545,42,961400
42,129,800100,618445,1480,904,904,0,904,730,174,1480,1480,0,0,1480,1440,1113,319,2,1,0,5,40,38,2,0,0,0,1480,18,1462,1480,694,786,1113,42,800100
42,129,800200,363989,1562,767,767,0,767,662,105,1562,1562,0,0,1562,1523,1266,247,4,3,0,3,39,34,5,0,0,0,1562,28,1534,1562,757,805,1266,42,800200
42,129,800300,922095,2625,1305,1305,0,1305,1197,108,2625,2625,0,0,2625,2602,2429,157,4,4,1,7,23,21,2,0,0,0,2625,18,2607,2625,1178,1447,2429,42,800300
42,129,800400,1425991,1525,788,788,0,788,734,54,1525,1525,0,0,1525,1513,1463,44,1,2,0,3,12,9,3,0,0,0,1525,11,1514,1525,700,825,1463,42,800400
42,129,800500,2360695,2789,1284,1284,0,1284,1242,42,2789,2789,0,0,2789,2773,2698,64,0,7,0,4,16,16,0,0,0,0,2789,9,2780,2789,1326,1463,2698,42,800500
42,129,800600,618185,2824,1356,1356,0,1356,1144,212,2824,2824,0,0,2824,2773,2245,488,4,10,1,25,51,46,5,0,0,0,2824,23,2801,2824,1382,1442,2245,42,800600
42,129,800700,1435573,2656,1666,1666,0,1666,1329,337,2656,2656,0,0,2656,2572,1930,607,9,9,0,17,84,76,7,1,0,0,2656,38,2618,2656,1221,1435,1930,42,800700
42,129,800800,1126460,1979,860,860,0,860,828,32,1979,1979,0,0,1979,1966,1918,42,0,2,0,4,13,12,1,0,0,0,1979,12,1967,1979,941,1038,1918,42,800800
42,129,800900,3256530,2928,1355,1355,0,1355,1242,113,2928,2928,0,0,2928,2872,2661,202,4,4,0,1,56,55,1,0,0,0,2928,13,2915,2928,1329,1599,2661,42,800900
42,129,801001,2972531,4274,1726,1726,0,1726,1686,40,4274,4274,0,0,4274,4254,4230,16,1,3,0,4,20,20,0,0,0,0,4274,19,4255,4274,2023,2251,4230,42,801001
42,129,801002,16125404,2824,1237,1237,0,1237,1169,68,2824,2824,0,0,2824,2804,2714,67,2,18,2,1,20,19,1,0,0,0,2824,6,2818,2824,1348,1476,2714,42,801002
42,129,801100,10868776,5510,2361,2361,0,2361,2278,83,5510,5510,0,0,5510,5472,5405,34,1,24,0,8,38,36,2,0,0,0,5510,31,5479,5510,2566,2944,5405,42,801100
42,129,801200,56259828,5706,2273,2273,0,2273,2171,102,5706,5706,0,0,5706,5675,5626,25,12,9,0,3,31,29,2,0,0,0,5706,8,5698,5706,2870,2836,5626,42,801200
42,129,801300,26620232,4099,1727,1727,0,1727,1636,91,4099,4099,0,0,4099,4075,4022,35,1,3,1,13,24,20,4,0,0,0,4099,18,4081,4099,1980,2119,4022,42,801300
42,129,801400,2115444,2022,933,933,0,933,857,76,2022,2022,0,0,2022,1993,1949,32,8,1,0,3,29,24,5,0,0,0,2022,2,2020,2022,985,1037,1949,42,801400
42,129,801500,887711,2689,1384,1384,0,1384,1213,171,2689,2689,0,0,2689,2669,2594,72,1,0,1,1,20,18,2,0,0,0,2689,12,2677,2689,1231,1458,2594,42,801500
42,129,801600,530703,1486,830,830,0,830,677,153,1486,1486,0,0,1486,1452,1347,85,3,12,0,5,34,34,0,0,0,0,1486,6,1480,1486,664,822,1347,42,801600
42,129,801701,39311363,2240,914,914,0,914,856,58,2240,2240,0,0,2240,2229,2158,63,1,7,0,0,11,11,0,0,0,0,2240,10,2230,2240,1132,1108,2158,42,801701
42,129,801702,45228930,4644,1860,1860,0,1860,1779,81,4644,4644,0,0,4644,4638,4604,23,2,4,0,5,6,6,0,0,0,0,4644,10,4634,4644,2330,2314,4604,42,801702
42,129,801703,36870673,2740,1101,1101,0,1101,1030,71,2740,2740,0,0,2740,2732,2706,21,0,3,0,2,8,8,0,0,0,0,2740,8,2732,2740,1322,1418,2706,42,801703
42,129,801800,112789909,6494,2712,2712,0,2712,2530,182,6494,6494,0,0,6494,6468,6384,63,1,7,0,13,26,25,1,0,0,0,6494,28,6466,6494,3203,3291,6384,42,801800
42,129,801900,122087654,6939,3117,3117,0,3117,2932,185,6939,6939,0,0,6939,6890,6792,84,6,4,1,3,49,45,0,1,3,0,6939,11,6928,6939,3394,3545,6792,42,801900
42,129,802001,33795580,2401,897,897,0,897,842,55,2401,2401,0,0,2401,2393,2346,10,1,30,0,6,8,8,0,0,0,0,2401,24,2377,2401,1230,1171,2346,42,802001
42,129,802002,13581748,7254,3130,3130,0,3130,2930,200,7254,7254,0,0,7254,7206,7036,34,1,131,1,3,48,39,4,0,5,0,7254,40,7214,7254,3530,3724,7036,42,802002
42,129,802101,16977079,5163,2057,2057,0,2057,1985,72,5163,5163,0,0,5163,5139,4821,40,7,252,0,19,24,17,6,1,0,0,5163,24,5139,5163,2471,2692,4821,42,802101
42,129,802102,22100638,5160,2050,2050,0,2050,1979,71,5160,5160,0,0,5160,5132,4975,30,1,123,1,2,28,25,1,0,2,0,5160,17,5143,5160,2588,2572,4975,42,802102
42,129,802103,12962725,2286,914,914,0,914,872,42,2286,2286,0,0,2286,2267,2149,16,0,100,0,2,19,16,3,0,0,0,2286,12,2274,2286,1140,1146,2149,42,802103
42,129,802200,3244929,3205,1621,1621,0,1621,1516,105,3205,3205,0,0,3205,3188,3149,22,1,10,0,6,17,17,0,0,0,0,3205,13,3192,3205,1489,1716,3149,42,802200
42,129,802301,22838381,5983,2265,2265,0,2265,2192,73,5983,5983,0,0,5983,5959,5879,44,11,18,1,6,24,21,0,0,3,0,5983,22,5961,5983,2933,3050,5879,42,802301
42,129,802302,27963364,9489,3261,3261,0,3261,3188,73,9489,9489,0,0,9489,9450,9347,25,1,57,3,17,39,39,0,0,0,0,9489,49,9440,9489,4708,4781,9347,42,802302
42,129,802400,29512673,4328,1656,1656,0,1656,1585,71,4328,4328,0,0,4328,4313,4289,5,5,14,0,0,15,15,0,0,0,0,4328,16,4312,4328,2097,2231,4289,42,802400
42,129,802500,1455790,2413,1115,1115,0,1115,1058,57,2413,2413,0,0,2413,2386,2331,42,4,4,2,3,27,27,0,0,0,0,2413,17,2396,2413,1118,1295,2331,42,802500
42,129,802600,1626996,3920,1768,1768,0,1768,1608,160,3920,3920,0,0,3920,3870,3740,114,4,0,2,10,50,50,0,0,0,0,3920,15,3905,3920,1841,2079,3740,42,802600
42,129,802700,1682174,2019,984,984,0,984,921,63,2019,2019,0,0,2019,2011,1973,33,1,4,0,0,8,8,0,0,0,0,2019,5,2014,2019,943,1076,1973,42,802700
42,129,802800,1886517,2762,1459,1459,0,1459,1225,234,2762,2762,0,0,2762,2673,2288,371,0,2,0,12,89,81,4,4,0,0,2762,16,2746,2762,1279,1483,2288,42,802800
42,129,802900,9980779,5123,1966,1966,0,1966,1893,73,5123,5123,0,0,5123,5101,5045,25,2,17,2,10,22,20,2,0,0,0,5123,38,5085,5123,2508,2615,5045,42,802900
42,129,803000,2814358,5245,2670,2670,0,2670,2465,205,5245,5245,0,0,5245,5204,5082,45,8,52,1,16,41,35,4,2,0,0,5245,31,5214,5245,2469,2776,5082,42,803000
42,129,803100,9601087,4238,1728,1728,0,1728,1659,69,4238,4238,0,0,4238,4227,4201,13,0,13,0,0,11,11,0,0,0,0,4238,18,4220,4238,2014,2224,4201,42,803100
42,129,803200,17326563,2782,1144,1144,0,1144,1085,59,2782,2782,0,0,2782,2777,2759,4,2,12,0,0,5,5,0,0,0,0,2782,12,2770,2782,1384,1398,2759,42,803200
42,129,803301,7344049,5822,2469,2469,0,2469,2375,94,5822,5822,0,0,5822,5797,5751,13,2,24,3,4,25,23,2,0,0,0,5822,34,5788,5822,2853,2969,5751,42,803301
42,129,803302,11217967,3584,1466,1466,0,1466,1436,30,3584,3584,0,0,3584,3569,3553,5,1,10,0,0,15,11,4,0,0,0,3584,11,3573,3584,1693,1891,3553,42,803302
42,129,803400,4109892,2131,858,858,0,858,846,12,2131,2131,0,0,2131,2128,2112,5,0,11,0,0,3,3,0,0,0,0,2131,5,2126,2131,1021,1110,2112,42,803400
42,129,803500,16403012,8239,2991,2991,0,2991,2923,68,8239,8239,0,0,8239,8210,8138,30,7,32,1,2,29,29,0,0,0,0,8239,26,8213,8239,3988,4251,8138,42,803500
42,129,803600,8182398,1926,812,812,0,812,765,47,1926,1926,0,0,1926,1921,1886,10,4,15,6,0,5,5,0,0,0,0,1926,6,1920,1926,934,992,1886,42,803600
42,129,803700,16154591,4125,1678,1678,0,1678,1592,86,4125,4125,0,0,4125,4105,4048,24,1,27,0,5,20,19,1,0,0,0,4125,8,4117,4125,1916,2209,4048,42,803700
42,129,803800,39804383,4897,2088,2088,0,2088,1978,110,4897,4897,0,0,4897,4873,4762,67,0,38,0,6,24,20,4,0,0,0,4897,18,4879,4897,2356,2541,4762,42,803800
42,129,803900,6082780,7128,3333,3333,0,3333,3131,202,7128,7128,0,0,7128,7066,6719,230,7,79,1,30,62,55,7,0,0,0,7128,104,7024,7128,3071,4057,6719,42,803900
42,129,804000,1334455,1572,805,805,0,805,726,79,1572,1572,0,0,1572,1538,1397,134,0,1,0,6,34,27,6,1,0,0,1572,13,1559,1572,741,831,1397,42,804000
42,129,804100,1272829,3049,1711,1711,0,1711,1522,189,3049,3049,0,0,3049,2957,2779,147,4,16,0,11,92,90,2,0,0,0,3049,29,3020,3049,1464,1585,2779,42,804100
42,129,804200,2311605,4152,1889,1889,0,1889,1769,120,4152,4152,0,0,4152,4105,3961,110,3,16,1,14,47,44,3,0,0,0,4152,26,4126,4152,1874,2278,3961,42,804200
42,129,804300,1034805,2398,1187,1187,0,1187,1097,90,2398,2398,0,0,2398,2376,2317,42,3,4,1,9,22,20,2,0,0,0,2398,11,2387,2398,1132,1266,2317,42,804300
42,129,804400,1912906,2280,1129,1129,0,1129,1048,81,2280,2280,0,0,2280,2265,2240,15,1,2,0,7,15,13,2,0,0,0,2280,12,2268,2280,1066,1214,2240,42,804400
42,129,804501,17696634,4824,1818,1818,0,1818,1751,67,4824,4824,0,0,4824,4808,4709,27,1,58,5,8,16,16,0,0,0,0,4824,19,4805,4824,2371,2453,4709,42,804501
42,129,804502,9973092,5721,2655,2655,0,2655,2514,141,5721,5721,0,0,5721,5691,5523,49,6,104,2,7,30,26,4,0,0,0,5721,41,5680,5721,2651,3070,5523,42,804502
42,129,804600,4765019,4138,1601,1601,0,1601,1506,95,4138,4138,0,0,4138,4128,3628,482,10,7,0,1,10,10,0,0,0,0,4138,98,4040,4138,2391,1747,3628,42,804600
42,129,804701,18997938,3317,1269,1269,0,1269,1240,29,3317,3317,0,0,3317,3305,3275,22,3,3,0,2,12,11,1,0,0,0,3317,10,3307,3317,1666,1651,3275,42,804701
42,129,804702,7430625,5591,2025,2025,0,2025,1938,87,5591,5591,0,0,5591,5571,5361,161,6,32,3,8,20,20,0,0,0,0,5591,17,5574,5591,2701,2890,5361,42,804702
42,129,804801,8163141,1840,972,972,0,972,881,91,1840,1840,0,0,1840,1831,1772,23,0,34,0,2,9,9,0,0,0,0,1840,14,1826,1840,896,944,1772,42,804801
42,129,804802,28944688,6124,2477,2477,0,2477,2383,94,6124,6124,0,0,6124,6103,6004,62,7,22,2,6,21,21,0,0,0,0,6124,22,6102,6124,2966,3158,6004,42,804802
42,129,804900,56433191,5508,2490,2490,0,2490,2335,155,5508,5508,0,0,5508,5482,5394,44,8,25,0,11,26,25,1,0,0,0,5508,30,5478,5508,2747,2761,5394,42,804900
42,129,805000,40508442,3953,1711,1711,0,1711,1610,101,3953,3953,0,0,3953,3939,3911,5,11,6,1,5,14,13,1,0,0,0,3953,25,3928,3953,1925,2028,3911,42,805000
42,129,805100,29187429,2913,1235,1235,0,1235,1176,59,2913,2913,0,0,2913,2903,2889,7,0,4,0,3,10,10,0,0,0,0,2913,12,2901,2913,1430,1483,2889,42,805100
42,129,805200,1820607,2359,1205,1205,0,1205,1045,160,2359,2359,0,0,2359,2313,2016,279,0,5,0,13,46,41,5,0,0,0,2359,17,2342,2359,1075,1284,2016,42,805200
42,129,805400,2072491,2258,1272,1272,0,1272,1003,269,2258,2258,0,0,2258,2190,1395,765,6,9,1,14,68,68,0,0,0,0,2258,30,2228,2258,1003,1255,1395,42,805400
42,129,805500,3624090,4052,1991,1991,0,1991,1868,123,4052,4052,0,0,4052,4025,3846,169,2,6,0,2,27,25,2,0,0,0,4052,24,4028,4052,1901,2151,3846,42,805500
42,129,805600,1130702,2107,992,992,0,992,928,64,2107,2107,0,0,2107,2096,2053,27,1,12,2,1,11,11,0,0,0,0,2107,19,2088,2107,957,1150,2053,42,805600
42,129,805800,21827430,3323,1425,1425,0,1425,1336,89,3323,3323,0,0,3323,3289,3150,123,3,1,1,11,34,32,2,0,0,0,3323,25,3298,3323,1573,1750,3150,42,805800
42,129,805900,61535452,8311,3495,3495,0,3495,3254,241,8311,8311,0,0,8311,8279,8123,103,11,32,2,8,32,31,1,0,0,0,8311,36,8275,8311,4104,4207,8123,42,805900
42,129,806000,2938386,3083,1410,1410,0,1410,1318,92,3083,3083,0,0,3083,3058,3006,35,5,7,0,5,25,24,1,0,0,0,3083,13,3070,3083,1429,1654,3006,42,806000
42,129,806100,51701197,3831,1614,1614,0,1614,1539,75,3831,3831,0,0,3831,3811,3766,40,1,2,0,2,20,20,0,0,0,0,3831,10,3821,3831,1863,1968,3766,42,806100
42,129,806200,65873067,2788,1179,1179,0,1179,1110,69,2788,2788,0,0,2788,2756,2727,16,7,3,1,2,32,31,1,0,0,0,2788,13,2775,2788,1387,1401,2727,42,806200
42,129,806300,1112804,2093,999,999,0,999,911,88,2093,2093,0,0,2093,2085,2043,34,1,3,2,2,8,8,0,0,0,0,2093,5,2088,2093,995,1098,2043,42,806300
42,129,806400,1905441,2679,1215,1215,0,1215,1123,92,2679,2679,0,0,2679,2669,2640,19,4,3,1,2,10,10,0,0,0,0,2679,12,2667,2679,1226,1453,2640,42,806400
42,129,806500,44056908,4727,1952,1952,0,1952,1879,73,4727,4727,0,0,4727,4711,4662,30,1,14,0,4,16,16,0,0,0,0,4727,15,4712,4727,2266,2461,4662,42,806500
42,129,806600,40872224,3054,1337,1337,0,1337,1263,74,3054,3054,0,0,3054,3040,3016,7,6,3,2,6,14,12,1,1,0,0,3054,8,3046,3054,1470,1584,3016,42,806600
42,129,806700,2011875,3066,1433,1433,0,1433,1342,91,3066,3066,0,0,3066,3039,2980,42,7,9,0,1,27,25,2,0,0,0,3066,9,3057,3066,1387,1679,2980,42,806700
42,129,806800,954940,1662,794,794,0,794,715,79,1662,1662,0,0,1662,1656,1611,37,0,2,0,6,6,6,0,0,0,0,1662,6,1656,1662,764,898,1611,42,806800
42,129,806900,26859723,4029,1700,1700,0,1700,1603,97,4029,4029,0,0,4029,4002,3975,18,0,4,0,5,27,27,0,0,0,0,4029,15,4014,4029,1911,2118,3975,42,806900
42,129,807000,85152242,3562,1510,1510,0,1510,1384,126,3562,3562,0,0,3562,3550,3545,3,1,0,0,1,12,12,0,0,0,0,3562,15,3547,3562,1748,1814,3545,42,807000
42,129,807100,32425275,3562,1458,1458,0,1458,1398,60,3562,3562,0,0,3562,3558,3544,7,0,1,1,5,4,4,0,0,0,0,3562,14,3548,3562,1764,1798,3544,42,807100
42,129,807200,58540736,7042,2848,2848,0,2848,2718,130,7042,7042,0,0,7042,7019,6914,16,4,74,2,9,23,22,1,0,0,0,7042,20,7022,7042,3477,3565,6914,42,807200
42,129,807300,52698766,5077,2129,2129,0,2129,2014,115,5077,5077,0,0,5077,5060,5034,5,14,6,0,1,17,16,1,0,0,0,5077,15,5062,5077,2484,2593,5034,42,807300
42,129,807401,34536708,2314,946,946,0,946,899,47,2314,2314,0,0,2314,2306,2293,5,6,2,0,0,8,8,0,0,0,0,2314,9,2305,2314,1136,1178,2293,42,807401
42,129,807402,28254296,7099,2636,2636,0,2636,2507,129,7099,7099,0,0,7099,7063,6892,42,6,99,2,22,36,35,1,0,0,0,7099,45,7054,7099,3478,3621,6892,42,807402
42,129,807500,1632477,2500,1125,1125,0,1125,1063,62,2500,2500,0,0,2500,2494,2458,6,2,26,0,2,6,6,0,0,0,0,2500,5,2495,2500,1188,1312,2458,42,807500
42,129,807600,2637856,2806,1424,1424,0,1424,1295,129,2806,2806,0,0,2806,2794,2768,11,5,7,0,3,12,12,0,0,0,0,2806,6,2800,2806,1307,1499,2768,42,807600
42,129,807700,1681894,3688,1709,1709,0,1709,1608,101,3688,3688,0,0,3688,3678,3658,12,0,7,0,1,10,10,0,0,0,0,3688,22,3666,3688,1716,1972,3658,42,807700
42,129,807800,10191843,3902,1753,1753,0,1753,1667,86,3902,3902,0,0,3902,3892,3875,9,2,6,0,0,10,10,0,0,0,0,3902,9,3893,3902,1870,2032,3875,42,807800
42,129,807900,141932976,6612,2788,2788,0,2788,2575,213,6612,6612,0,0,6612,6581,6544,20,2,11,0,4,31,31,0,0,0,0,6612,16,6596,6612,3278,3334,6544,42,807900
42,129,808100,98294505,4807,1930,1930,0,1930,1728,202,4807,4807,0,0,4807,4791,4636,145,1,5,1,3,16,15,1,0,0,0,4807,44,4763,4807,2430,2377,4636,42,808100
42,129,808200,2095664,2991,1317,1317,0,1317,1235,82,2991,2991,0,0,2991,2983,2961,19,1,0,0,2,8,8,0,0,0,0,2991,14,2977,2991,1419,1572,2961,42,808200
42,129,808300,232124634,5703,2617,2617,0,2617,2248,369,5703,5703,0,0,5703,5667,5617,13,24,2,0,11,36,35,1,0,0,0,5703,28,5675,5703,2841,2862,5617,42,808300
42,129,808400,238270545,7163,3667,3667,0,3667,2994,673,7163,7163,0,0,7163,7134,7108,9,3,9,0,5,29,28,1,0,0,0,7163,22,7141,7163,3512,3651,7108,42,808400
42,129,808500,1260615,1695,907,907,0,907,827,80,1695,1695,0,0,1695,1692,1691,0,0,1,0,0,3,3,0,0,0,0,1695,6,1689,1695,774,921,1691,42,808500
42,129,808600,250547747,5010,2467,2467,0,2467,1949,518,5010,5010,0,0,5010,4997,4985,3,0,3,0,6,13,12,1,0,0,0,5010,23,4987,5010,2531,2479,4985,42,808600
42,131,400100,115830359,3068,1522,1522,0,1522,1181,341,3068,3068,0,0,3068,3052,3029,5,7,8,0,3,16,12,3,1,0,0,3068,22,3046,3068,1480,1588,3029,42,400100
42,131,400200,375772824,4071,2006,2006,0,2006,1574,432,4071,4071,0,0,4071,4029,3997,7,12,4,0,9,42,40,2,0,0,0,4071,32,4039,4071,2034,2037,3997,42,400200
42,131,400300,95168321,4561,1811,1811,0,1811,1612,199,4561,4561,0,0,4561,4537,4433,57,13,24,0,10,24,23,1,0,0,0,4561,38,4523,4561,2232,2329,4433,42,400300
42,131,400400,80576765,4298,1822,1822,0,1822,1624,198,4298,4298,0,0,4298,4274,4223,19,6,16,1,9,24,24,0,0,0,0,4298,33,4265,4298,2094,2204,4223,42,400400
42,131,400500,87209998,4277,2018,2018,0,2018,1651,367,4277,4277,0,0,4277,4250,4185,45,1,13,1,5,27,27,0,0,0,0,4277,35,4242,4277,2247,2030,4185,42,400500
42,131,400600,96011929,3555,1730,1730,0,1730,1485,245,3555,3555,0,0,3555,3541,3519,5,6,9,0,2,14,13,1,0,0,0,3555,13,3542,3555,1688,1867,3519,42,400600
42,131,400700,178172702,4250,1804,1804,0,1804,1635,169,4250,4250,0,0,4250,4231,4212,11,2,3,0,3,19,19,0,0,0,0,4250,14,4236,4250,2164,2086,4212,42,400700
42,133,100,489613,1315,876,876,0,876,684,192,1315,1315,0,0,1315,1278,734,354,7,13,1,169,37,33,4,0,0,0,1315,296,1019,1315,698,617,734,42,100
42,133,200,387342,2829,1361,1361,0,1361,1098,263,2829,2829,0,0,2829,2704,1328,855,13,34,1,473,125,110,15,0,0,0,2829,723,2106,2829,1323,1506,1328,42,200
42,133,300,537825,2215,1051,1051,0,1051,894,157,2215,2215,0,0,2215,2123,1511,360,15,102,0,135,92,84,8,0,0,0,2215,317,1898,2215,1100,1115,1511,42,300
42,133,400,582453,1954,904,904,0,904,815,89,1954,1954,0,0,1954,1907,1554,249,2,37,0,65,47,44,3,0,0,0,1954,146,1808,1954,951,1003,1554,42,400
42,133,500,595307,2388,1144,1144,0,1144,1041,103,2388,2388,0,0,2388,2309,1504,596,5,72,0,132,79,75,4,0,0,0,2388,391,1997,2388,1121,1267,1504,42,500
42,133,600,1620968,2561,1090,1090,0,1090,1002,88,2561,2561,0,0,2561,2468,1662,606,10,23,1,166,93,93,0,0,0,0,2561,380,2181,2561,1236,1325,1662,42,600
42,133,700,465087,3228,1293,1293,0,1293,1035,258,3228,3228,0,0,3228,3048,884,1504,29,16,6,609,180,164,16,0,0,0,3228,1093,2135,3228,1555,1673,884,42,700
42,133,800,863791,2077,942,942,0,942,842,100,2077,2077,0,0,2077,2001,1314,569,2,27,2,87,76,64,12,0,0,0,2077,149,1928,2077,985,1092,1314,42,800
42,133,900,507326,2623,1009,1009,0,1009,892,117,2623,2623,0,0,2623,2520,1374,1027,9,39,2,69,103,96,7,0,0,0,2623,199,2424,2623,1285,1338,1374,42,900
42,133,1000,570801,1593,663,663,0,663,555,108,1593,1593,0,0,1593,1505,535,655,6,5,0,304,88,84,2,2,0,0,1593,454,1139,1593,752,841,535,42,1000
42,133,1100,503133,3388,1409,1409,0,1409,1167,242,3388,3388,0,0,3388,3239,1772,987,15,42,0,423,149,148,1,0,0,0,3388,703,2685,3388,1647,1741,1772,42,1100
42,133,1200,529451,2637,1248,1248,0,1248,1022,226,2637,2637,0,0,2637,2561,1790,512,3,14,0,242,76,71,5,0,0,0,2637,453,2184,2637,1317,1320,1790,42,1200
42,133,1300,1321691,2826,1342,1342,0,1342,1232,110,2826,2826,0,0,2826,2724,2234,289,10,26,2,163,102,101,1,0,0,0,2826,292,2534,2826,1410,1416,2234,42,1300
42,133,1400,2971987,4246,1941,1941,0,1941,1862,79,4246,4246,0,0,4246,4127,3358,462,15,97,7,188,119,108,9,2,0,0,4246,340,3906,4246,1941,2305,3358,42,1400
42,133,1500,778841,3624,1500,1500,0,1500,1345,155,3624,3624,0,0,3624,3455,1974,926,24,12,3,516,169,163,6,0,0,0,3624,874,2750,3624,1654,1970,1974,42,1500
42,133,1600,680989,1464,805,805,0,805,692,113,1464,1464,0,0,1464,1434,975,333,7,15,4,100,30,29,1,0,0,0,1464,221,1243,1464,768,696,975,42,1600
42,133,10110,16916818,7513,2521,2521,0,2521,2454,67,7513,7513,0,0,7513,7411,6364,715,8,221,3,100,102,96,6,0,0,0,7513,409,7104,7513,4100,3413,6364,42,10110
42,133,10120,11737120,4223,1830,1830,0,1830,1788,42,4223,4223,0,0,4223,4186,3994,93,2,60,0,37,37,29,7,1,0,0,4223,70,4153,4223,2095,2128,3994,42,10120
42,133,10130,4914431,3149,1190,1190,0,1190,1168,22,3149,3149,0,0,3149,3111,2916,68,2,97,0,28,38,36,0,2,0,0,3149,49,3100,3149,1541,1608,2916,42,10130
42,133,10210,5558663,3269,1468,1468,0,1468,1413,55,3269,3269,0,0,3269,3250,3119,49,1,54,0,27,19,17,2,0,0,0,3269,49,3220,3269,1485,1784,3119,42,10210
42,133,10220,4234155,5729,2474,2474,0,2474,2407,67,5729,5729,0,0,5729,5684,5374,97,13,156,5,39,45,44,1,0,0,0,5729,84,5645,5729,2679,3050,5374,42,10220
42,133,10300,2376650,1697,727,727,0,727,698,29,1697,1697,0,0,1697,1683,1647,13,3,10,1,9,14,13,1,0,0,0,1697,25,1672,1697,807,890,1647,42,10300
42,133,10400,3592688,3672,1597,1597,0,1597,1536,61,3672,3672,0,0,3672,3638,3523,75,4,25,0,11,34,33,1,0,0,0,3672,60,3612,3672,1745,1927,3523,42,10400
42,133,10510,9411666,4404,1059,1059,0,1059,1017,42,4404,4404,0,0,4404,4370,4236,68,1,41,1,23,34,33,1,0,0,0,4404,85,4319,4404,1934,2470,4236,42,10510
42,133,10520,1910389,2201,960,960,0,960,929,31,2201,2201,0,0,2201,2185,2108,43,1,25,0,8,16,15,1,0,0,0,2201,26,2175,2201,1059,1142,2108,42,10520
42,133,20100,12340040,3474,1581,1581,0,1581,1419,162,3474,3474,0,0,3474,3430,3247,89,9,48,1,36,44,41,2,1,0,0,3474,87,3387,3474,1723,1751,3247,42,20100
42,133,20210,58427858,7755,2978,2978,0,2978,2871,107,7755,7755,0,0,7755,7688,7552,33,6,72,8,17,67,62,5,0,0,0,7755,71,7684,7755,3868,3887,7552,42,20210
42,133,20220,21448198,3092,1229,1229,0,1229,1190,39,3092,3092,0,0,3092,3069,3019,3,2,23,3,19,23,22,1,0,0,0,3092,28,3064,3092,1540,1552,3019,42,20220
42,133,20310,33537410,2132,881,881,0,881,807,74,2132,2132,0,0,2132,2123,2102,8,2,7,0,4,9,8,1,0,0,0,2132,23,2109,2132,1080,1052,2102,42,20310
42,133,20320,164098533,7174,2831,2831,0,2831,2710,121,7174,7174,0,0,7174,7122,7061,22,6,25,0,8,52,46,6,0,0,0,7174,55,7119,7174,3601,3573,7061,42,20320
42,133,20410,50188670,5047,1991,1991,0,1991,1915,76,5047,5047,0,0,5047,5015,4971,9,7,19,3,6,32,32,0,0,0,0,5047,31,5016,5047,2526,2521,4971,42,20410
42,133,20420,40918757,6778,2669,2669,0,2669,2588,81,6778,6778,0,0,6778,6726,6611,29,12,64,2,8,52,51,1,0,0,0,6778,43,6735,6778,3303,3475,6611,42,20420
42,133,20510,52215986,3600,1359,1359,0,1359,1313,46,3600,3600,0,0,3600,3587,3538,18,3,15,1,12,13,13,0,0,0,0,3600,22,3578,3600,1857,1743,3538,42,20510
42,133,20521,16680396,4875,1918,1918,0,1918,1851,67,4875,4875,0,0,4875,4838,4744,22,6,31,0,35,37,35,2,0,0,0,4875,90,4785,4875,2453,2422,4744,42,20521
42,133,20522,43331893,3270,1294,1294,0,1294,1247,47,3270,3270,0,0,3270,3259,3247,2,3,5,0,2,11,9,2,0,0,0,3270,8,3262,3270,1661,1609,3247,42,20522
42,133,20600,90141770,6930,2706,2706,0,2706,2630,76,6930,6930,0,0,6930,6887,6821,28,11,21,0,6,43,43,0,0,0,0,6930,23,6907,6930,3569,3361,6821,42,20600
42,133,20710,7427896,5210,2196,2196,0,2196,2123,73,5210,5210,0,0,5210,5180,5052,61,19,27,0,21,30,30,0,0,0,0,5210,57,5153,5210,2550,2660,5052,42,20710
42,133,20720,12500449,7749,3105,3105,0,3105,3016,89,7749,7749,0,0,7749,7687,7455,96,11,45,1,79,62,60,2,0,0,0,7749,133,7616,7749,3727,4022,7455,42,20720
42,133,20800,63257560,5278,2113,2113,0,2113,2005,108,5278,5278,0,0,5278,5233,5131,71,9,14,0,8,45,36,5,2,2,0,5278,35,5243,5278,2654,2624,5131,42,20800
42,133,20910,22083761,5592,2259,2259,0,2259,2068,191,5592,5592,0,0,5592,5529,5430,34,14,23,1,27,63,61,2,0,0,0,5592,95,5497,5592,2821,2771,5430,42,20910
42,133,20921,25135861,6898,2658,2658,0,2658,2553,105,6898,6898,0,0,6898,6844,6703,73,2,43,3,20,54,52,2,0,0,0,6898,104,6794,6898,3393,3505,6703,42,20921
42,133,20922,33852272,3975,1609,1609,0,1609,1535,74,3975,3975,0,0,3975,3948,3887,24,8,16,3,10,27,26,0,0,1,0,3975,41,3934,3975,2027,1948,3887,42,20922
42,133,21010,23649257,3501,1400,1400,0,1400,1353,47,3501,3501,0,0,3501,3488,3393,45,9,30,0,11,13,13,0,0,0,0,3501,41,3460,3501,1738,1763,3393,42,21010
42,133,21020,22848603,5300,2214,2214,0,2214,2130,84,5300,5300,0,0,5300,5255,5171,36,9,13,0,26,45,43,2,0,0,0,5300,63,5237,5300,2620,2680,5171,42,21020
42,133,21100,12416185,3639,1636,1636,0,1636,1576,60,3639,3639,0,0,3639,3602,3417,82,6,58,1,38,37,36,1,0,0,0,3639,80,3559,3639,1752,1887,3417,42,21100
42,133,21210,11145095,6331,2729,2729,0,2729,2601,128,6331,6331,0,0,6331,6244,5915,125,2,121,1,80,87,83,4,0,0,0,6331,145,6186,6331,2981,3350,5915,42,21210
42,133,21220,18345576,4419,1535,1535,0,1535,1499,36,4419,4419,0,0,4419,4394,4223,96,7,48,2,18,25,24,1,0,0,0,4419,47,4372,4419,2235,2184,4223,42,21220
42,133,21300,1277588,4321,2010,2010,0,2010,1897,113,4321,4321,0,0,4321,4251,4051,121,13,7,0,59,70,69,1,0,0,0,4321,128,4193,4321,2021,2300,4051,42,21300
42,133,21410,8520410,4421,1983,1983,0,1983,1911,72,4421,4421,0,0,4421,4353,4131,112,2,72,0,36,68,60,3,5,0,0,4421,75,4346,4421,1924,2497,4131,42,21410
42,133,21420,6387593,6086,2387,2387,0,2387,2337,50,6086,6086,0,0,6086,6045,5889,62,6,83,0,5,41,37,4,0,0,0,6086,43,6043,6086,2982,3104,5889,42,21420
42,133,21500,14044399,3660,1735,1735,0,1735,1654,81,3660,3660,0,0,3660,3634,3564,21,3,27,1,18,26,22,0,0,4,0,3660,39,3621,3660,1735,1925,3564,42,21500
42,133,21600,22976505,2762,1268,1268,0,1268,1187,81,2762,2762,0,0,2762,2727,2600,77,2,28,1,19,35,35,0,0,0,0,2762,44,2718,2762,1414,1348,2600,42,21600
42,133,21711,37442167,2970,1104,1104,0,1104,1082,22,2970,2970,0,0,2970,2945,2908,14,9,4,2,8,25,24,0,1,0,0,2970,19,2951,2970,1503,1467,2908,42,21711
42,133,21712,65578390,6127,2255,2255,0,2255,2197,58,6127,6127,0,0,6127,6081,6028,14,9,9,0,21,46,39,7,0,0,0,6127,45,6082,6127,3116,3011,6028,42,21712
42,133,21720,23874520,3559,1463,1463,0,1463,1426,37,3559,3559,0,0,3559,3547,3494,11,3,21,0,18,12,12,0,0,0,0,3559,35,3524,3559,1769,1790,3494,42,21720
42,133,21800,26437040,7641,2709,2709,0,2709,2637,72,7641,7641,0,0,7641,7604,7477,31,11,54,0,31,37,36,1,0,0,0,7641,59,7582,7641,3754,3887,7477,42,21800
42,133,21900,6591928,6951,2934,2934,0,2934,2784,150,6951,6951,0,0,6951,6904,6744,41,14,65,3,37,47,46,1,0,0,0,6951,94,6857,6951,3389,3562,6744,42,21900
42,133,22000,1004163,3622,1688,1688,0,1688,1578,110,3622,3622,0,0,3622,3600,3530,12,10,26,0,22,22,22,0,0,0,0,3622,85,3537,3622,1749,1873,3530,42,22000
42,133,22100,1573378,3017,1530,1530,0,1530,1415,115,3017,3017,0,0,3017,2986,2874,44,5,20,0,43,31,30,1,0,0,0,3017,109,2908,3017,1475,1542,2874,42,22100
42,133,22200,4660393,3988,1844,1844,0,1844,1774,70,3988,3988,0,0,3988,3975,3919,5,6,23,0,22,13,13,0,0,0,0,3988,49,3939,3988,1874,2114,3919,42,22200
42,133,22300,2216737,3908,1920,1920,0,1920,1838,82,3908,3908,0,0,3908,3875,3769,14,6,58,8,20,33,33,0,0,0,0,3908,55,3853,3908,1842,2066,3769,42,22300
42,133,22400,106222339,7984,2864,2864,0,2864,2794,70,7984,7984,0,0,7984,7934,7847,40,11,28,1,7,50,49,1,0,0,0,7984,39,7945,7984,4068,3916,7847,42,22400
42,133,22500,86701521,3646,1398,1398,0,1398,1344,54,3646,3646,0,0,3646,3621,3584,3,16,9,0,9,25,21,4,0,0,0,3646,8,3638,3646,1832,1814,3584,42,22500
42,133,22600,72830919,6000,2383,2383,0,2383,2286,97,6000,6000,0,0,6000,5967,5919,18,8,22,0,0,33,32,0,0,1,0,6000,32,5968,6000,2986,3014,5919,42,22600
42,133,22700,17245725,6342,2987,2987,0,2987,2829,158,6342,6342,0,0,6342,6317,6089,124,5,68,2,29,25,25,0,0,0,0,6342,65,6277,6342,2890,3452,6089,42,22700
42,133,22800,16390939,7008,2911,2911,0,2911,2820,91,7008,7008,0,0,7008,6955,6775,86,12,74,0,8,53,52,1,0,0,0,7008,88,6920,7008,3384,3624,6775,42,22800
42,133,22910,16317970,6415,2802,2802,0,2802,2684,118,6415,6415,0,0,6415,6335,6036,126,3,123,3,44,80,70,10,0,0,0,6415,147,6268,6415,3168,3247,6036,42,22910
42,133,22920,16016350,3872,1558,1558,0,1558,1524,34,3872,3872,0,0,3872,3850,3780,23,13,28,1,5,22,22,0,0,0,0,3872,37,3835,3872,1933,1939,3780,42,22920
42,133,23000,2541478,5109,2163,2163,0,2163,2059,104,5109,5109,0,0,5109,5040,4937,45,9,20,5,24,69,65,4,0,0,0,5109,90,5019,5109,2443,2666,4937,42,23000
42,133,23100,3324870,6149,2729,2729,0,2729,2575,154,6149,6149,0,0,6149,6072,5972,37,15,25,3,20,77,70,6,1,0,0,6149,56,6093,6149,2962,3187,5972,42,23100
42,133,23200,33527548,5457,2144,2144,0,2144,2061,83,5457,5457,0,0,5457,5430,5376,18,5,20,0,11,27,26,1,0,0,0,5457,41,5416,5457,2701,2756,5376,42,23200
42,133,23300,38266645,8681,3465,3465,0,3465,3329,136,8681,8681,0,0,8681,8627,8492,40,8,62,5,20,54,54,0,0,0,0,8681,85,8596,8681,4271,4410,8492,42,23300
42,133,23400,49584828,4441,2034,2034,0,2034,1881,153,4441,4441,0,0,4441,4403,4328,34,7,17,1,16,38,38,0,0,0,0,4441,45,4396,4441,2230,2211,4328,42,23400
42,133,23500,25501979,5244,2226,2226,0,2226,2136,90,5244,5244,0,0,5244,5199,5116,39,3,20,1,20,45,42,3,0,0,0,5244,75,5169,5244,2588,2656,5116,42,23500
42,133,23600,66315099,8322,3429,3429,0,3429,3144,285,8322,8322,0,0,8322,8270,8213,11,8,9,0,29,52,47,5,0,0,0,8322,95,8227,8322,4173,4149,8213,42,23600
42,133,23710,55842981,3502,1381,1381,0,1381,1322,59,3502,3502,0,0,3502,3476,3450,12,3,8,0,3,26,22,4,0,0,0,3502,14,3488,3502,1774,1728,3450,42,23710
42,133,23720,233470477,8872,3426,3426,0,3426,3183,243,8872,8872,0,0,8872,8824,8689,51,27,38,2,17,48,48,0,0,0,0,8872,52,8820,8872,4516,4356,8689,42,23720
42,133,23810,53027042,4443,1747,1747,0,1747,1679,68,4443,4443,0,0,4443,4425,4369,31,3,18,1,3,18,18,0,0,0,0,4443,27,4416,4443,2231,2212,4369,42,23810
42,133,23821,12897433,4494,1710,1710,0,1710,1653,57,4494,4494,0,0,4494,4453,4345,32,11,56,1,8,41,37,4,0,0,0,4494,26,4468,4494,2153,2341,4345,42,23821
42,133,23822,23324718,6009,2325,2325,0,2325,2271,54,6009,6009,0,0,6009,5982,5891,32,7,34,5,13,27,27,0,0,0,0,6009,62,5947,6009,2953,3056,5891,42,23822
42,133,23900,129912005,9541,3545,3545,0,3545,3388,157,9541,9541,0,0,9541,9486,9329,85,11,39,1,21,55,50,3,2,0,0,9541,84,9457,9541,4778,4763,9329,42,23900
42,133,24000,150626831,8343,3368,3368,0,3368,2952,416,8343,8343,0,0,8343,8301,8114,118,25,27,0,17,42,42,0,0,0,0,8343,39,8304,8343,4219,4124,8114,42,24000